,query_name,y_mask_size,pred_mask_size,intersection_size,wrong_pred_size,union,IOU,percent_y
0,0,527.0,807,0,807,160000.0,0.0,0.0
1,2,1494.0,2396,760,1636,159240.0,0.0047726701833710125,0.31719532554257096
2,3,1047.0,2816,4,2812,159996.0,2.500062501562539e-05,0.0014204545454545455
3,4,165.0,4512,22,4490,159978.0,0.00013751890884996688,0.004875886524822695
4,5,1480.0,1010,33,977,159967.0,0.0002062925478379916,0.032673267326732675
5,7,76.0,4524,0,4524,160000.0,0.0,0.0
6,9,168.0,9276,0,9276,160000.0,0.0,0.0
7,11,174.0,8739,14,8725,159986.0,8.75076569199805e-05,0.0016020139604073693
8,12,400.0,826,51,775,159949.0,0.0003188516339583242,0.06174334140435835
9,14,15.0,6,0,6,160000.0,0.0,0.0
10,15,881.0,9581,212,9369,159788.0,0.0013267579542894335,0.022127126604738544
11,16,347.0,5402,213,5189,159787.0,0.001333024588984085,0.03942984079970381
12,17,469.0,6746,286,6460,159714.0,0.0017907008778191016,0.042395493625852355
13,18,1284.0,4139,872,3267,159128.0,0.005479865265698054,0.2106789079487799
14,19,239.0,2823,144,2679,159856.0,0.000900810729656691,0.05100956429330499
15,20,1303.0,2506,649,1857,159351.0,0.004072770174018362,0.2589784517158819
16,23,100.0,3672,0,3672,160000.0,0.0,0.0
17,24,7442.0,10104,6182,3922,153818.0,0.04019035483493479,0.6118368962787015
18,25,1447.0,5368,360,5008,159640.0,0.0022550739163117012,0.06706408345752608
19,26,1010.0,4577,620,3957,159380.0,0.0038900740368929604,0.13545990823683635
20,27,548.0,5565,124,5441,159876.0,0.0007756010908454052,0.022282120395327943
21,28,211.0,7492,0,7492,160000.0,0.0,0.0
22,29,4956.0,8445,2970,5475,157030.0,0.01891358339170859,0.35168738898756663
23,30,707.0,3070,499,2571,159501.0,0.003128507031303879,0.16254071661237784
24,31,2258.0,13574,1847,11727,158153.0,0.011678564428117077,0.1360689553558273
25,32,387.0,584,34,550,159966.0,0.00021254516584774265,0.05821917808219178
26,34,12855.0,16860,11247,5613,148753.0,0.07560855915510947,0.6670818505338079
27,35,434.0,1251,90,1161,159910.0,0.0005628165843286849,0.07194244604316546
28,36,605.0,5185,515,4670,159485.0,0.0032291438066275827,0.09932497589199614
29,39,108.0,3348,2,3346,159998.0,1.250015625195315e-05,0.0005973715651135006
30,40,282.0,3077,0,3077,160000.0,0.0,0.0
31,42,4289.0,8299,3099,5200,156901.0,0.019751308149724985,0.37341848415471746
32,43,1101.0,1018,72,946,159928.0,0.0004502025911660247,0.07072691552062868
33,44,3660.0,3867,2428,1439,157572.0,0.01540882897976798,0.6278769071631756
34,45,2483.0,3342,715,2627,159285.0,0.004488809366858147,0.2139437462597247
35,46,87.0,13641,87,13554,159913.0,0.0005440458249172988,0.0063778315372773255
36,47,69.0,4711,51,4660,159949.0,0.0003188516339583242,0.010825727021863723
37,48,1181.0,8719,561,8158,159439.0,0.0035185870458294393,0.06434224108269297
38,49,1023.0,11722,862,10860,159138.0,0.005416682376302329,0.07353693908889268
39,50,1218.0,11325,947,10378,159053.0,0.005953990179374171,0.08362030905077263
40,51,225.0,4362,30,4332,159970.0,0.00018753516284303307,0.0068775790921595595
41,52,1235.0,10084,156,9928,159844.0,0.0009759515527639448,0.015470051566838556
42,53,3217.0,3183,1098,2085,158902.0,0.006909919321342714,0.3449575871819039
43,54,3287.0,4348,637,3711,159363.0,0.003997163708012525,0.14650413983440663
44,56,399.0,3882,0,3882,160000.0,0.0,0.0
45,57,11823.0,13191,8779,4412,151221.0,0.058054106241857945,0.665529527708286
46,58,747.0,14346,59,14287,159941.0,0.0003688860267223539,0.0041126446396208
47,59,515.0,1291,0,1291,160000.0,0.0,0.0
48,60,2133.0,4917,956,3961,159044.0,0.00601091521843012,0.19442749644091925
49,61,7390.0,11380,5541,5839,154459.0,0.0358735975242621,0.48690685413005275
50,62,242.0,3318,26,3292,159974.0,0.00016252641054171303,0.007836045810729355
51,63,79.0,1977,0,1977,160000.0,0.0,0.0
52,64,1508.0,4977,1012,3965,158988.0,0.0063652602712154375,0.2033353425758489
53,65,915.0,5865,787,5078,159213.0,0.004943063694547556,0.13418584825234442
54,66,1529.0,16332,884,15448,159116.0,0.00555569521606878,0.05412686749938771
55,67,1783.0,12037,1295,10742,158705.0,0.008159793327242367,0.10758494641521973
56,68,2359.0,13314,1542,11772,158458.0,0.009731285261709728,0.11581793600721045
57,69,400.0,1584,71,1513,159929.0,0.00044394700148190757,0.04482323232323232
58,70,1525.0,1558,253,1305,159747.0,0.0015837543115050673,0.16238767650834404
59,71,1539.0,7587,1096,6491,158904.0,0.006897246136031818,0.14445762488467115
60,72,1666.0,14601,1187,13414,158813.0,0.007474199215429468,0.08129580165742073
61,73,1311.0,13139,1042,12097,158958.0,0.006555190679298935,0.07930588324834462
62,74,7440.0,9264,4461,4803,155539.0,0.028680909611094322,0.48154145077720206
63,75,4474.0,10555,2243,8312,157757.0,0.014218069562681845,0.21250592136428234
64,76,1531.0,12149,946,11203,159054.0,0.00594766557269858,0.0778664910692238
65,77,3997.0,3991,994,2997,159006.0,0.006251336427556193,0.24906038586820345
66,78,7312.0,18581,5781,12800,154219.0,0.03748565351869744,0.31112426672407295
67,79,13070.0,34076,12024,22052,147976.0,0.08125641995999351,0.3528583167038385
68,80,23293.0,28387,19781,8606,140219.0,0.14107217994708277,0.6968330573854229
69,81,3567.0,19500,2935,16565,157065.0,0.01868653105402222,0.1505128205128205
70,82,3993.0,14752,2629,12123,157371.0,0.016705746293789833,0.17821312364425163
71,83,6772.0,17096,5916,11180,154084.0,0.03839464188364788,0.34604585868039306
72,84,15498.0,20975,13382,7593,146618.0,0.09127119453273132,0.6379976162097736
73,85,12987.0,14636,7999,6637,152001.0,0.05262465378517247,0.5465291063132003
74,86,31702.0,40245,27831,12414,132169.0,0.21057131399950063,0.691539321654864
75,87,1327.0,2450,99,2351,159901.0,0.0006191330885985703,0.04040816326530612
76,88,1455.0,4125,150,3975,159850.0,0.0009383797309978105,0.03636363636363636
77,89,1558.0,815,63,752,159937.0,0.0003939051001331774,0.07730061349693251
78,90,4441.0,12669,3028,9641,156972.0,0.01929006447009658,0.2390086036782698
79,91,413.0,1428,119,1309,159881.0,0.0007443035757844897,0.08333333333333333
80,92,1437.0,1797,838,959,159162.0,0.005265075834684158,0.46633277685030605
81,93,604.0,908,56,852,159944.0,0.0003501225428900115,0.06167400881057269
82,94,14.0,3319,0,3319,160000.0,0.0,0.0
83,95,808.0,2184,335,1849,159665.0,0.0020981429868787774,0.1533882783882784
84,96,3779.0,10318,2456,7862,157544.0,0.01558929568882344,0.23803062609032757
85,97,3297.0,9360,2733,6627,157267.0,0.017378089491120196,0.2919871794871795
86,98,13659.0,20470,10753,9717,149247.0,0.07204834938055707,0.5253053248656571
87,99,3868.0,6795,2609,4186,157391.0,0.016576551391121474,0.3839587932303164
88,100,11257.0,24168,9449,14719,150551.0,0.06276278470418663,0.39097153260509765
89,101,924.0,9182,754,8428,159246.0,0.0047348128053451895,0.08211718579830102
90,102,208.0,3396,0,3396,160000.0,0.0,0.0
91,103,322.0,7125,200,6925,159800.0,0.0012515644555694619,0.028070175438596492
92,104,658.0,8396,312,8084,159688.0,0.0019538099293622564,0.037160552644116246
93,105,94.0,25494,79,25415,159921.0,0.0004939939094928121,0.003098768337648074
94,106,248.0,9788,32,9756,159968.0,0.00020004000800160032,0.0032693093583980384
95,107,1001.0,2695,100,2595,159900.0,0.0006253908692933083,0.03710575139146568
96,108,294.0,2375,80,2295,159920.0,0.0005002501250625312,0.03368421052631579
97,109,3821.0,8357,3080,5277,156920.0,0.01962783583991843,0.3685533086035659
98,110,1549.0,3813,1036,2777,158964.0,0.0065171988626355655,0.2717020718594283
99,111,851.0,4183,0,4183,160000.0,0.0,0.0
100,112,1430.0,11822,1325,10497,158675.0,0.008350401764613203,0.11207917442057182
101,113,1160.0,3350,788,2562,159212.0,0.0049493756752003615,0.23522388059701493
102,114,118.0,4527,46,4481,159954.0,0.0002875826800205059,0.010161254694057875
103,115,8428.0,14174,7447,6727,152553.0,0.04881582138666562,0.5253986171863976
104,116,1369.0,2332,194,2138,159806.0,0.0012139719409784363,0.08319039451114923
105,117,2503.0,2697,977,1720,159023.0,0.006143765367273916,0.3622543566926214
106,118,125.0,3252,0,3252,160000.0,0.0,0.0
107,119,423.0,10812,317,10495,159683.0,0.0019851831441042565,0.029319274879763227
108,120,1208.0,6988,826,6162,159174.0,0.00518928970811816,0.11820263308528907
109,121,1370.0,1631,110,1521,159890.0,0.0006879729814247295,0.0674432863274065
110,122,1368.0,14016,1019,12997,158981.0,0.006409570955019782,0.07270262557077625
111,123,388.0,1076,38,1038,159962.0,0.00023755641964966678,0.03531598513011153
112,124,702.0,15113,621,14492,159379.0,0.003896372796918038,0.04109045192880302
113,125,168.0,2192,31,2161,159969.0,0.00019378754633710282,0.014142335766423358
114,126,43.0,3436,39,3397,159961.0,0.00024380942854820863,0.011350407450523865
115,127,226.0,775,0,775,160000.0,0.0,0.0
116,128,2534.0,5894,2011,3883,157989.0,0.01272873427896879,0.34119443501866303
117,129,162.0,3242,68,3174,159932.0,0.00042518070179826424,0.020974706971005553
118,130,1741.0,427,103,324,159897.0,0.0006441646810134024,0.24121779859484777
119,131,3984.0,9635,2486,7149,157514.0,0.01578272407532029,0.2580176440062273
120,132,1439.0,13258,1164,12094,158836.0,0.007328313480571155,0.08779604766933173
121,133,1226.0,196,0,196,160000.0,0.0,0.0
122,134,502.0,9601,261,9340,159739.0,0.0016339153243728833,0.02718466826372253
123,135,1479.0,150,139,11,159861.0,0.0008695053828013087,0.9266666666666666
124,136,5231.0,8060,3630,4430,156370.0,0.0232141715162755,0.45037220843672454
125,137,251.0,10916,193,10723,159807.0,0.0012077067963230648,0.017680469036277024
126,138,841.0,13857,563,13294,159437.0,0.003531175323168399,0.04062928483798802
127,139,9.0,426,0,426,160000.0,0.0,0.0
128,140,8878.0,18965,6470,12495,153530.0,0.04214160099003452,0.34115475876614815
129,141,3285.0,6880,1500,5380,158500.0,0.00946372239747634,0.2180232558139535
130,142,902.0,3948,422,3526,159578.0,0.0026444748022910426,0.10688956433637285
131,143,1490.0,3851,397,3454,159603.0,0.0024874219156281524,0.10309010646585302
132,144,4774.0,13036,3288,9748,156712.0,0.02098116289754454,0.2522246087756981
133,145,28.0,0,0,0,160000.0,0.0,0.0
134,146,3963.0,7880,3528,4352,156472.0,0.02254716498798507,0.44771573604060916
135,147,27.0,1346,0,1346,160000.0,0.0,0.0
136,148,696.0,751,134,617,159866.0,0.0008382019941701174,0.17842876165113183
137,151,423.0,368,1,367,159999.0,6.250039062744142e-06,0.002717391304347826
138,152,17.0,2038,0,2038,160000.0,0.0,0.0
139,153,705.0,3743,454,3289,159546.0,0.0028455743171248416,0.12129308041677798
140,154,30.0,6514,14,6500,159986.0,8.75076569199805e-05,0.0021492170709241634
141,156,176.0,7763,0,7763,160000.0,0.0,0.0
142,158,120.0,108,0,108,160000.0,0.0,0.0
143,159,1578.0,2862,845,2017,159155.0,0.005309289686155006,0.2952480782669462
144,160,1702.0,1558,719,839,159281.0,0.004514034944531991,0.4614890885750963
145,161,1000.0,3695,355,3340,159645.0,0.0022236837984277616,0.09607577807848444
146,162,72.0,5360,0,5360,160000.0,0.0,0.0
147,163,1395.0,5387,1109,4278,158891.0,0.0069796275434102625,0.20586597364024503
148,164,931.0,1792,6,1786,159994.0,3.7501406302736355e-05,0.0033482142857142855
149,165,2129.0,574,114,460,159886.0,0.0007130080182129767,0.1986062717770035
150,168,620.0,2761,137,2624,159863.0,0.0008569837923722187,0.04961970300615719
151,169,390.0,788,10,778,159990.0,6.250390649415588e-05,0.012690355329949238
152,170,433.0,3057,158,2899,159842.0,0.0009884761201686665,0.051684658161596335
153,171,20.0,281,0,281,160000.0,0.0,0.0
154,172,109.0,277,0,277,160000.0,0.0,0.0
155,173,199.0,3131,44,3087,159956.0,0.0002750756458025957,0.01405301820504631
156,174,25085.0,30159,21189,8970,138811.0,0.1526464041034212,0.7025763453695414
157,175,22880.0,36273,20192,16081,139808.0,0.14442664225223162,0.5566674937281173
158,176,1756.0,4431,801,3630,159199.0,0.005031438639689948,0.18077183480027081
159,177,105.0,5127,0,5127,160000.0,0.0,0.0
160,178,424.0,1323,0,1323,160000.0,0.0,0.0
161,179,3780.0,5549,2284,3265,157716.0,0.014481726647898754,0.4116056947197693
162,180,3025.0,8066,2260,5806,157740.0,0.014327374160010143,0.28018844532606
163,181,869.0,3989,644,3345,159356.0,0.004041266096036547,0.16144397092003007
164,182,8338.0,11286,6424,4862,153576.0,0.0418294525186227,0.5692007797270955
165,183,1339.0,3187,382,2805,159618.0,0.002393213797942588,0.1198619391277063
166,184,1280.0,8062,533,7529,159467.0,0.003342384317758533,0.06611262713966758
167,185,4094.0,5918,2154,3764,157846.0,0.013646212130811044,0.3639743156471781
168,186,4475.0,5285,2378,2907,157622.0,0.015086726472192969,0.4499526963103122
169,187,6006.0,5768,3433,2335,156567.0,0.021926715080444793,0.5951803051317615
170,188,1511.0,908,112,796,159888.0,0.0007004903432402681,0.12334801762114538
171,189,4591.0,7246,2214,5032,157786.0,0.014031663138681505,0.3055478884902015
172,190,22783.0,28516,18816,9700,141184.0,0.13327289211242066,0.6598400897741619
173,191,13746.0,17920,11799,6121,148201.0,0.07961484740318892,0.6584263392857143
174,192,3198.0,17252,1566,15686,158434.0,0.0098842420187586,0.09077208439601206
175,193,4072.0,7152,2048,5104,157952.0,0.012965964343598054,0.28635346756152125
176,194,7954.0,12786,4210,8576,155790.0,0.02702355735284678,0.32926638510871264
177,195,7374.0,15621,3305,12316,156695.0,0.021091930182839273,0.21157416298572435
178,196,4178.0,5918,3129,2789,156871.0,0.019946325324629793,0.5287259209192294
179,197,14163.0,14530,9593,4937,150407.0,0.06378027618395421,0.6602202339986235
180,198,8257.0,12822,6851,5971,153149.0,0.044734213086601936,0.5343160193417563
181,199,17344.0,19295,13202,6093,146798.0,0.0899331053556588,0.6842187095102358
182,200,130.0,35,0,35,160000.0,0.0,0.0
183,201,545.0,1493,10,1483,159990.0,6.250390649415588e-05,0.006697923643670462
184,202,656.0,691,134,557,159866.0,0.0008382019941701174,0.1939218523878437
185,203,16276.0,20461,14116,6345,145884.0,0.09676181075374955,0.6898978544548164
186,204,13922.0,18642,11546,7096,148454.0,0.07777493364948064,0.6193541465507992
187,205,902.0,1323,455,868,159545.0,0.0028518599768090507,0.3439153439153439
188,206,4785.0,10669,3385,7284,156615.0,0.021613510838680842,0.3172743462367607
189,208,75.0,725,0,725,160000.0,0.0,0.0
190,209,702.0,1114,1,1113,159999.0,6.250039062744142e-06,0.0008976660682226212
191,210,1372.0,9872,577,9295,159423.0,0.0036193021082277965,0.05844813614262561
192,211,825.0,5132,524,4608,159476.0,0.0032857608668388975,0.10210444271239283
193,212,403.0,2323,291,2032,159709.0,0.001822063878679348,0.12526904864399482
194,213,1550.0,1241,588,653,159412.0,0.003688555441246581,0.47381144238517325
195,214,122.0,1198,0,1198,160000.0,0.0,0.0
196,215,1144.0,3413,817,2596,159183.0,0.005132457611679639,0.2393788455903897
197,216,914.0,3362,684,2678,159316.0,0.004293354088729318,0.20345032718619868
198,217,946.0,9699,266,9433,159734.0,0.0016652685088960396,0.027425507784307662
199,218,2436.0,1455,860,595,159140.0,0.005404046751288174,0.5910652920962199
200,219,4787.0,7415,3180,4235,156820.0,0.02027802576202015,0.42886041807147673
201,220,898.0,15571,845,14726,159155.0,0.005309289686155006,0.05426754864812793
202,221,91.0,8294,0,8294,160000.0,0.0,0.0
203,222,303.0,134,0,134,160000.0,0.0,0.0
204,223,332.0,450,0,450,160000.0,0.0,0.0
205,224,190.0,765,41,724,159959.0,0.0002563156808932289,0.05359477124183006
206,225,32.0,185,0,185,160000.0,0.0,0.0
207,226,239.0,21,0,21,160000.0,0.0,0.0
208,227,6684.0,11820,5741,6079,154259.0,0.03721662917560726,0.4857021996615905
209,228,815.0,2099,42,2057,159958.0,0.00026256892434263994,0.020009528346831826
210,229,2918.0,6445,2102,4343,157898.0,0.013312391543908092,0.326144297905353
211,230,1809.0,17168,547,16621,159453.0,0.003430477946479527,0.03186160298229264
212,231,3941.0,15621,3052,12569,156948.0,0.01944593113642735,0.19537801677229372
213,232,888.0,1585,72,1513,159928.0,0.0004502025911660247,0.045425867507886436
214,233,524.0,4424,0,4424,160000.0,0.0,0.0
215,234,4816.0,11468,3371,8097,156629.0,0.02152219576195979,0.2939483780955703
216,235,4988.0,4834,3117,1717,156883.0,0.019868309504535227,0.64480761274307
217,236,1.0,5753,0,5753,160000.0,0.0,0.0
218,237,639.0,1453,191,1262,159809.0,0.0011951767422360444,0.13145216792842396
219,238,576.0,4965,365,4600,159635.0,0.002286466000563786,0.07351460221550855
220,239,529.0,3156,325,2831,159675.0,0.002035384374510725,0.10297845373891001
221,240,1056.0,1943,828,1115,159172.0,0.005201919935667077,0.4261451363870304
222,241,3703.0,6916,2049,4867,157951.0,0.012972377509480788,0.29626951995373046
223,242,1000.0,151,7,144,159993.0,4.37519141462439e-05,0.046357615894039736
224,243,57.0,1688,4,1684,159996.0,2.500062501562539e-05,0.002369668246445498
225,244,91.0,1048,0,1048,160000.0,0.0,0.0
226,245,93.0,1445,0,1445,160000.0,0.0,0.0
227,247,1318.0,5124,1112,4012,158888.0,0.006998640551835255,0.21701795472287275
228,248,13.0,872,0,872,160000.0,0.0,0.0
229,250,444.0,2949,175,2774,159825.0,0.0010949475989363367,0.0593421498813157
230,251,480.0,2884,398,2486,159602.0,0.0024937030864274883,0.13800277392510402
231,252,86.0,7871,7,7864,159993.0,4.37519141462439e-05,0.0008893406174564859
232,253,4010.0,11909,3070,8839,156930.0,0.019562862422736253,0.2577882273910488
233,254,1505.0,253,183,70,159817.0,0.0011450596619883991,0.7233201581027668
234,255,794.0,2490,37,2453,159963.0,0.00023130348893181548,0.014859437751004016
235,256,5624.0,14893,4517,10376,155483.0,0.029051407549378388,0.303296850869536
236,257,687.0,4670,310,4360,159690.0,0.0019412611935625274,0.06638115631691649
237,258,328.0,2063,220,1843,159780.0,0.0013768932281887595,0.10664081434803684
238,259,213.0,4526,120,4406,159880.0,0.0007505629221916438,0.026513477684489615
239,260,249.0,2138,0,2138,160000.0,0.0,0.0
240,261,52.0,1194,0,1194,160000.0,0.0,0.0
241,262,98.0,11081,41,11040,159959.0,0.0002563156808932289,0.0037000270733688295
242,264,120.0,5685,23,5662,159977.0,0.00014377066703338606,0.0040457343887423045
243,265,48.0,2223,0,2223,160000.0,0.0,0.0
244,0,527.0,771,0,771,160000.0,0.0,0.0
245,2,1494.0,2389,758,1631,159242.0,0.004760050740382563,0.3172875680200921
246,3,1047.0,2621,3,2618,159997.0,1.8750351569091922e-05,0.0011446012972148034
247,4,165.0,1849,0,1849,160000.0,0.0,0.0
248,5,1480.0,256,29,227,159971.0,0.00018128285751792513,0.11328125
249,7,76.0,4220,0,4220,160000.0,0.0,0.0
250,9,168.0,12485,0,12485,160000.0,0.0,0.0
251,11,174.0,9725,16,9709,159984.0,0.00010001000100010001,0.0016452442159383034
252,12,400.0,1201,75,1126,159925.0,0.0004689698296076286,0.06244796003330558
253,14,15.0,388,0,388,160000.0,0.0,0.0
254,15,881.0,4754,162,4592,159838.0,0.0010135261952727136,0.0340765671013883
255,16,347.0,3603,124,3479,159876.0,0.0007756010908454052,0.034415764640577294
256,17,469.0,10016,304,9712,159696.0,0.0019036168720569081,0.03035143769968051
257,18,1284.0,4003,817,3186,159183.0,0.005132457611679639,0.2040969273045216
258,19,239.0,1947,141,1806,159859.0,0.0008820272865462689,0.0724191063174114
259,20,1303.0,2359,611,1748,159389.0,0.0038333887533016707,0.2590080542602798
260,23,100.0,8505,0,8505,160000.0,0.0,0.0
261,24,7442.0,10007,6207,3800,153793.0,0.04035944418796694,0.6202658139302488
262,25,1447.0,4228,180,4048,159820.0,0.0011262670504317356,0.04257332071901608
263,26,1010.0,4252,578,3674,159422.0,0.0036255974708634944,0.1359360301034807
264,27,548.0,7746,380,7366,159620.0,0.00238065405337677,0.049057578104828296
265,28,211.0,7002,0,7002,160000.0,0.0,0.0
266,29,4956.0,13509,3536,9973,156464.0,0.02259944779629819,0.26175142497594195
267,30,707.0,3053,413,2640,159587.0,0.002587930094556574,0.13527677694071405
268,31,2258.0,15141,1881,13260,158119.0,0.0118961035675662,0.12423221715870815
269,32,387.0,530,37,493,159963.0,0.00023130348893181548,0.06981132075471698
270,34,12855.0,16601,11131,5470,148869.0,0.07477043575223855,0.6705017770013855
271,35,434.0,2400,250,2150,159750.0,0.001564945226917058,0.10416666666666667
272,36,605.0,3929,512,3417,159488.0,0.0032102728731942215,0.13031305675744465
273,39,108.0,2814,0,2814,160000.0,0.0,0.0
274,40,282.0,4342,0,4342,160000.0,0.0,0.0
275,42,4289.0,9391,3157,6234,156843.0,0.02012840866344051,0.33617293153018846
276,43,1101.0,908,0,908,160000.0,0.0,0.0
277,44,3660.0,5695,2654,3041,157346.0,0.016867286108321788,0.46602282704126424
278,45,2483.0,9170,1050,8120,158950.0,0.006605850896508336,0.11450381679389313
279,46,87.0,11935,87,11848,159913.0,0.0005440458249172988,0.0072894847088395475
280,47,69.0,6726,61,6665,159939.0,0.0003813954069989183,0.009069283377936367
281,48,1181.0,8796,581,8215,159419.0,0.0036444840326435367,0.06605275125056843
282,49,1023.0,6398,843,5555,159157.0,0.005296656760305861,0.13175992497655517
283,50,1218.0,12615,1007,11608,158993.0,0.006333612171605039,0.07982560443915973
284,51,225.0,4887,45,4842,159955.0,0.00028132912381607326,0.009208103130755065
285,52,1235.0,8833,1,8832,159999.0,6.250039062744142e-06,0.00011321181931393638
286,53,3217.0,4549,1319,3230,158681.0,0.008312274311354227,0.2899538360079138
287,54,3287.0,3800,567,3233,159433.0,0.0035563528253247443,0.14921052631578946
288,56,399.0,2955,0,2955,160000.0,0.0,0.0
289,57,11823.0,13027,8800,4227,151200.0,0.0582010582010582,0.675520073693099
290,58,747.0,7283,42,7241,159958.0,0.00026256892434263994,0.005766854318275436
291,59,515.0,2943,0,2943,160000.0,0.0,0.0
292,60,2133.0,4437,859,3578,159141.0,0.005397729057879491,0.19359927879197655
293,61,7390.0,13997,5894,8103,154106.0,0.03824640182731367,0.42109023362149034
294,62,242.0,4236,35,4201,159965.0,0.00021879786203231956,0.008262511803588292
295,63,79.0,896,0,896,160000.0,0.0,0.0
296,64,1508.0,3766,962,2804,159038.0,0.006048868823803117,0.25544344131704727
297,65,915.0,7259,823,6436,159177.0,0.005170344961897761,0.1133764981402397
298,66,1529.0,9745,693,9052,159307.0,0.00435009133308643,0.07111339148281169
299,67,1783.0,6767,1261,5506,158739.0,0.007943857527135738,0.18634550022166396
300,68,2359.0,13584,1559,12025,158441.0,0.00983962484457937,0.11476737338044758
301,69,400.0,2287,73,2214,159927.0,0.0004564582590807056,0.031919545255793616
302,70,1525.0,983,263,720,159737.0,0.0016464563626460995,0.26754832146490337
303,71,1539.0,7868,1131,6737,158869.0,0.0071190729468933525,0.14374682257244534
304,72,1666.0,14709,1183,13526,158817.0,0.00744882474798038,0.08042694948670882
305,73,1311.0,12032,1011,11021,158989.0,0.006358930492046619,0.08402593085106383
306,74,7440.0,8245,4193,4052,155807.0,0.02691149948333515,0.5085506367495451
307,75,4474.0,11930,2351,9579,157649.0,0.014912876072794626,0.19706621961441745
308,76,1531.0,9983,857,9126,159143.0,0.005385093909251428,0.0858459380947611
309,77,3997.0,3381,971,2410,159029.0,0.006105804601676424,0.2871931381248151
310,78,7312.0,15215,5299,9916,154701.0,0.034253172248401756,0.3482747288859678
311,79,13070.0,33244,11934,21310,148066.0,0.0805991922521038,0.3589820719528336
312,80,23293.0,28358,19822,8536,140178.0,0.14140592675027466,0.6989914662529092
313,81,3567.0,16948,2854,14094,157146.0,0.018161454952719126,0.1683974510266698
314,82,3993.0,17320,2789,14531,157211.0,0.017740488897087354,0.16102771362586604
315,83,6772.0,13640,5851,7789,154149.0,0.03795678207448638,0.4289589442815249
316,84,15498.0,18692,13116,5576,146884.0,0.08929495384112633,0.7016905628076182
317,85,12987.0,16366,8337,8029,151663.0,0.05497055972781759,0.5094097519247219
318,86,31702.0,40860,28064,12796,131936.0,0.2127091923356779,0.6868330885952031
319,87,1327.0,2848,120,2728,159880.0,0.0007505629221916438,0.042134831460674156
320,88,1455.0,4053,140,3913,159860.0,0.00087576629550857,0.03454231433506045
321,89,1558.0,1199,208,991,159792.0,0.0013016921998598178,0.17347789824854046
322,90,4441.0,10783,2962,7821,157038.0,0.01886167679160458,0.2746916442548456
323,91,413.0,5176,107,5069,159893.0,0.0006691975258454092,0.020672333848531683
324,92,1437.0,1814,838,976,159162.0,0.005265075834684158,0.4619625137816979
325,93,604.0,896,80,816,159920.0,0.0005002501250625312,0.08928571428571429
326,94,14.0,2149,0,2149,160000.0,0.0,0.0
327,95,808.0,1422,253,1169,159747.0,0.0015837543115050673,0.1779184247538678
328,96,3779.0,11754,2612,9142,157388.0,0.016595928533306225,0.2222222222222222
329,97,3297.0,9040,2680,6360,157320.0,0.01703534197813374,0.29646017699115046
330,98,13659.0,20249,10703,9546,149297.0,0.07168931726692432,0.5285693120647933
331,99,3868.0,6334,2478,3856,157522.0,0.01573113596830919,0.3912219766340385
332,100,11257.0,19961,8768,11193,151232.0,0.057977147693609815,0.4392565502730324
333,101,924.0,7696,679,7017,159321.0,0.004261836167234702,0.08822765072765072
334,102,208.0,5884,34,5850,159966.0,0.00021254516584774265,0.005778382053025153
335,103,322.0,4828,231,4597,159769.0,0.0014458374277863666,0.047845898922949465
336,104,658.0,9280,359,8921,159641.0,0.0022487957354313743,0.038685344827586204
337,105,94.0,30213,79,30134,159921.0,0.0004939939094928121,0.0026147684771455995
338,106,248.0,17863,62,17801,159938.0,0.0003876502144581025,0.0034708615574091696
339,107,1001.0,2428,103,2325,159897.0,0.0006441646810134024,0.04242174629324547
340,108,294.0,1571,51,1520,159949.0,0.0003188516339583242,0.032463399108847865
341,109,3821.0,9962,3123,6839,156877.0,0.01990731592266553,0.3134912668138928
342,110,1549.0,3759,1043,2716,158957.0,0.006561522927584189,0.2774674115456238
343,111,851.0,10885,1,10884,159999.0,6.250039062744142e-06,9.186954524575104e-05
344,112,1430.0,9673,1328,8345,158672.0,0.008369466572552184,0.13728936214204487
345,113,1160.0,3292,788,2504,159212.0,0.0049493756752003615,0.2393681652490887
346,114,118.0,4379,46,4333,159954.0,0.0002875826800205059,0.010504681434117378
347,115,8428.0,14099,7461,6638,152539.0,0.04891208150046873,0.529186467125328
348,116,1369.0,2676,309,2367,159691.0,0.0019349869435347014,0.11547085201793722
349,117,2503.0,1894,966,928,159034.0,0.006074172818391036,0.5100316789862724
350,118,125.0,3357,0,3357,160000.0,0.0,0.0
351,119,423.0,10949,311,10638,159689.0,0.0019475355221712203,0.028404420495022377
352,120,1208.0,5651,819,4832,159181.0,0.005145086411066647,0.14493010086710317
353,121,1370.0,2013,128,1885,159872.0,0.0008006405124099279,0.06358668653750621
354,122,1368.0,14165,1078,13087,158922.0,0.006783201822277595,0.07610307094952347
355,123,388.0,2129,64,2065,159936.0,0.00040016006402561027,0.030061061531235323
356,124,702.0,12829,624,12205,159376.0,0.003915269551249875,0.04863980045210071
357,125,168.0,3808,33,3775,159967.0,0.0002062925478379916,0.008665966386554622
358,126,43.0,5367,39,5328,159961.0,0.00024380942854820863,0.0072666294019005035
359,127,226.0,839,0,839,160000.0,0.0,0.0
360,128,2534.0,5943,1985,3958,158015.0,0.012562098534949214,0.33400639407706545
361,129,162.0,2556,68,2488,159932.0,0.00042518070179826424,0.026604068857589983
362,130,1741.0,64,26,38,159974.0,0.00016252641054171303,0.40625
363,131,3984.0,8631,2381,6250,157619.0,0.015106046859832889,0.2758660641872321
364,132,1439.0,10341,1142,9199,158858.0,0.00718881013231943,0.11043419398510783
365,133,1226.0,3801,248,3553,159752.0,0.0015524062296559667,0.0652459878979216
366,134,502.0,9860,250,9610,159750.0,0.001564945226917058,0.02535496957403651
367,135,1479.0,251,108,143,159892.0,0.0006754559327546094,0.4302788844621514
368,136,5231.0,8548,3740,4808,156260.0,0.023934468194035583,0.43752924660739356
369,137,251.0,9452,186,9266,159814.0,0.00116385297908819,0.019678374947101143
370,138,841.0,15083,520,14563,159480.0,0.0032605969400551793,0.03447590001988994
371,139,9.0,15,0,15,160000.0,0.0,0.0
372,140,8878.0,19884,6667,13217,153333.0,0.04348052930549849,0.33529470931402133
373,141,3285.0,9689,1746,7943,158254.0,0.011032896482869311,0.18020435545463928
374,142,902.0,3535,353,3182,159647.0,0.0022111283018158815,0.09985855728429986
375,143,1490.0,6170,495,5675,159505.0,0.0031033509921319083,0.08022690437601297
376,144,4774.0,12348,3157,9191,156843.0,0.02012840866344051,0.2556689342403628
377,145,28.0,28,0,28,160000.0,0.0,0.0
378,146,3963.0,7140,3526,3614,156474.0,0.0225340951212342,0.4938375350140056
379,147,27.0,1185,0,1185,160000.0,0.0,0.0
380,148,696.0,2101,123,1978,159877.0,0.0007693414312252544,0.05854355069014755
381,151,423.0,914,73,841,159927.0,0.0004564582590807056,0.07986870897155361
382,152,17.0,1076,0,1076,160000.0,0.0,0.0
383,153,705.0,4226,472,3754,159528.0,0.002958728248332581,0.11168954093705631
384,154,30.0,6117,12,6105,159988.0,7.500562542190664e-05,0.00196174595389897
385,156,176.0,8902,0,8902,160000.0,0.0,0.0
386,158,120.0,305,0,305,160000.0,0.0,0.0
387,159,1578.0,3580,963,2617,159037.0,0.0060551947031194,0.2689944134078212
388,160,1702.0,2016,729,1287,159271.0,0.004577104432068613,0.36160714285714285
389,161,1000.0,3708,265,3443,159735.0,0.0016589977149654115,0.0714670981661273
390,162,72.0,3196,0,3196,160000.0,0.0,0.0
391,163,1395.0,4986,1072,3914,158928.0,0.00674519279170442,0.21500200561572402
392,164,931.0,2713,22,2691,159978.0,0.00013751890884996688,0.008109104312569112
393,165,2129.0,539,144,395,159856.0,0.000900810729656691,0.26716141001855287
394,168,620.0,939,22,917,159978.0,0.00013751890884996688,0.023429179978700747
395,169,390.0,690,8,682,159992.0,5.000250012500625e-05,0.011594202898550725
396,170,433.0,3553,168,3385,159832.0,0.001051103658841784,0.047283985364480724
397,171,20.0,78,0,78,160000.0,0.0,0.0
398,172,109.0,228,0,228,160000.0,0.0,0.0
399,173,199.0,3450,37,3413,159963.0,0.00023130348893181548,0.010724637681159421
400,174,25085.0,27911,20387,7524,139613.0,0.1460250836240178,0.730428863172226
401,175,22880.0,34448,19462,14986,140538.0,0.13848211871522292,0.564967487227125
402,176,1756.0,2672,590,2082,159410.0,0.003701147983188006,0.22080838323353294
403,177,105.0,7579,0,7579,160000.0,0.0,0.0
404,178,424.0,2016,8,2008,159992.0,5.000250012500625e-05,0.003968253968253968
405,179,3780.0,6675,2348,4327,157652.0,0.014893563037576434,0.3517602996254682
406,180,3025.0,6009,2102,3907,157898.0,0.013312391543908092,0.34980862040272925
407,181,869.0,3288,569,2719,159431.0,0.0035689420501659025,0.17305352798053528
408,182,8338.0,10855,6349,4506,153651.0,0.04132091558141503,0.5848917549516351
409,183,1339.0,4413,453,3960,159547.0,0.0028392887362344637,0.1026512576478586
410,184,1280.0,9251,642,8609,159358.0,0.004028665018386275,0.06939790292941303
411,185,4094.0,6240,2307,3933,157693.0,0.01462969186964545,0.3697115384615385
412,186,4475.0,5259,2392,2867,157608.0,0.0151768945738795,0.4548393230652215
413,187,6006.0,10499,4011,6488,155989.0,0.02571335158248338,0.3820363844175636
414,188,1511.0,668,37,631,159963.0,0.00023130348893181548,0.05538922155688623
415,189,4591.0,6157,1976,4181,158024.0,0.012504429706879967,0.32093552054572033
416,190,22783.0,29530,19195,10335,140805.0,0.1363232839742907,0.6500169319336269
417,191,13746.0,17071,11591,5480,148409.0,0.0781017323747212,0.6789877570148205
418,192,3198.0,13700,1519,12181,158481.0,0.009584745174500413,0.11087591240875913
419,193,4072.0,9716,2244,7472,157756.0,0.014224498592763509,0.23095924248662
420,194,7954.0,6994,3302,3692,156698.0,0.021072381268427167,0.4721189591078067
421,195,7374.0,15153,3242,11911,156758.0,0.02068156011176463,0.21395103279878572
422,196,4178.0,5679,3108,2571,156892.0,0.019809805471279605,0.5472794506075013
423,197,14163.0,15751,10118,5633,149882.0,0.0675064383982066,0.6423719128944194
424,198,8257.0,10410,6710,3700,153290.0,0.04377324026355274,0.6445725264169068
425,199,17344.0,18181,12845,5336,147155.0,0.08728891305086474,0.7065067928056763
426,200,130.0,462,27,435,159973.0,0.00016877848136873097,0.05844155844155844
427,201,545.0,1580,19,1561,159981.0,0.00011876410323725943,0.012025316455696202
428,202,656.0,166,40,126,159960.0,0.00025006251562890725,0.24096385542168675
429,203,16276.0,20764,14079,6685,145921.0,0.09648371379033861,0.6780485455596225
430,204,13922.0,17852,11389,6463,148611.0,0.0766363189804254,0.6379677347075958
431,205,902.0,1135,444,691,159556.0,0.002782722053699015,0.39118942731277534
432,206,4785.0,10012,3211,6801,156789.0,0.020479753043899762,0.32071514182980426
433,208,75.0,725,0,725,160000.0,0.0,0.0
434,209,702.0,1912,39,1873,159961.0,0.00024380942854820863,0.020397489539748955
435,210,1372.0,4563,572,3991,159428.0,0.0035878264796648015,0.12535612535612536
436,211,825.0,4733,542,4191,159458.0,0.0033990141604685873,0.11451510669765476
437,212,403.0,2438,297,2141,159703.0,0.0018597020719710964,0.12182116488925349
438,213,1550.0,1152,563,589,159437.0,0.003531175323168399,0.4887152777777778
439,214,122.0,564,0,564,160000.0,0.0,0.0
440,215,1144.0,3648,821,2827,159179.0,0.005157715527802034,0.22505482456140352
441,216,914.0,4637,766,3871,159234.0,0.004810530414358742,0.1651930127237438
442,217,946.0,10848,273,10575,159727.0,0.0017091662649395532,0.025165929203539824
443,218,2436.0,1391,874,517,159126.0,0.005492502796526024,0.6283249460819554
444,219,4787.0,7754,3270,4484,156730.0,0.02086390608052064,0.4217178230590663
445,220,898.0,14782,811,13971,159189.0,0.005094573117489273,0.05486402381274523
446,221,91.0,8180,0,8180,160000.0,0.0,0.0
447,222,303.0,343,0,343,160000.0,0.0,0.0
448,223,332.0,547,0,547,160000.0,0.0,0.0
449,224,190.0,1546,55,1491,159945.0,0.000343868204695364,0.03557567917205692
450,225,32.0,72,0,72,160000.0,0.0,0.0
451,226,239.0,97,3,94,159997.0,1.8750351569091922e-05,0.030927835051546393
452,227,6684.0,12535,5744,6791,154256.0,0.03723680116170522,0.45823693657758274
453,228,815.0,2817,59,2758,159941.0,0.0003688860267223539,0.020944266950656727
454,229,2918.0,6443,2124,4319,157876.0,0.013453596493450556,0.329660096228465
455,230,1809.0,21057,711,20346,159289.0,0.004463585056093013,0.03376549366006554
456,231,3941.0,10204,2942,7262,157058.0,0.01873193342586815,0.28831830654645235
457,232,888.0,413,70,343,159930.0,0.0004376914900268868,0.1694915254237288
458,233,524.0,1328,0,1328,160000.0,0.0,0.0
459,234,4816.0,12580,3093,9487,156907.0,0.01971231366350768,0.2458664546899841
460,235,4988.0,6216,3396,2820,156604.0,0.0216852698526219,0.5463320463320464
461,236,1.0,4797,0,4797,160000.0,0.0,0.0
462,237,639.0,1111,177,934,159823.0,0.0011074751443784687,0.15931593159315932
463,238,576.0,4445,363,4082,159637.0,0.00227390893088695,0.08166479190101238
464,239,529.0,2228,303,1925,159697.0,0.001897343093483284,0.1359964093357271
465,240,1056.0,1709,799,910,159201.0,0.005018812695900151,0.4675248683440609
466,241,3703.0,7299,2104,5195,157896.0,0.013325226731519481,0.2882586655706261
467,242,1000.0,288,38,250,159962.0,0.00023755641964966678,0.13194444444444445
468,243,57.0,1649,4,1645,159996.0,2.500062501562539e-05,0.002425712553062462
469,244,91.0,2842,0,2842,160000.0,0.0,0.0
470,245,93.0,1353,0,1353,160000.0,0.0,0.0
471,247,1318.0,5276,1120,4156,158880.0,0.007049345417925478,0.21228203184230476
472,248,13.0,503,0,503,160000.0,0.0,0.0
473,250,444.0,4431,220,4211,159780.0,0.0013768932281887595,0.04965019183028662
474,251,480.0,2477,390,2087,159610.0,0.0024434559238142974,0.15744852644327817
475,252,86.0,5971,0,5971,160000.0,0.0,0.0
476,253,4010.0,10717,3056,7661,156944.0,0.019471913548781732,0.2851544275450219
477,254,1505.0,267,193,74,159807.0,0.0012077067963230648,0.7228464419475655
478,255,794.0,1567,17,1550,159983.0,0.00010626129026209034,0.010848755583918315
479,256,5624.0,15122,4529,10593,155471.0,0.02913083468942761,0.29949742097606136
480,257,687.0,6301,392,5909,159608.0,0.0024560172422434965,0.06221234724646881
481,258,328.0,2546,253,2293,159747.0,0.0015837543115050673,0.09937156323644933
482,259,213.0,3831,94,3737,159906.0,0.0005878453591484997,0.02453667449752023
483,260,249.0,3217,0,3217,160000.0,0.0,0.0
484,261,52.0,1411,0,1411,160000.0,0.0,0.0
485,262,98.0,11967,35,11932,159965.0,0.00021879786203231956,0.002924709618116487
486,264,120.0,7859,23,7836,159977.0,0.00014377066703338606,0.0029265809899478305
487,265,48.0,1227,0,1227,160000.0,0.0,0.0
488,0,527.0,3027,0,3027,160000.0,0.0,0.0
489,2,1494.0,2396,788,1608,159212.0,0.0049493756752003615,0.328881469115192
490,3,1047.0,1970,5,1965,159995.0,3.125097659301853e-05,0.0025380710659898475
491,4,165.0,6943,3,6940,159997.0,1.8750351569091922e-05,0.00043208987469393634
492,5,1480.0,2983,41,2942,159959.0,0.0002563156808932289,0.013744552463962454
493,7,76.0,5019,0,5019,160000.0,0.0,0.0
494,9,168.0,7587,0,7587,160000.0,0.0,0.0
495,11,174.0,10110,26,10084,159974.0,0.00016252641054171303,0.0025717111770524235
496,12,400.0,1162,51,1111,159949.0,0.0003188516339583242,0.04388984509466437
497,14,15.0,245,0,245,160000.0,0.0,0.0
498,15,881.0,7418,172,7246,159828.0,0.0010761568686337812,0.023186842814774872
499,16,347.0,5033,196,4837,159804.0,0.0012265024655202623,0.03894297635605007
500,17,469.0,10884,305,10579,159695.0,0.0019098907292025423,0.028022785740536568
501,18,1284.0,4603,904,3699,159096.0,0.005682103886961332,0.19639365631110145
502,19,239.0,1288,133,1155,159867.0,0.0008319415514146134,0.10326086956521739
503,20,1303.0,2681,701,1980,159299.0,0.00440052982127948,0.26146960089518834
504,23,100.0,3068,0,3068,160000.0,0.0,0.0
505,24,7442.0,10008,6191,3817,153809.0,0.040251220669791754,0.6186051159072742
506,25,1447.0,3977,150,3827,159850.0,0.0009383797309978105,0.037716872014080964
507,26,1010.0,4803,623,4180,159377.0,0.003908970554095007,0.12971059754320216
508,27,548.0,3470,169,3301,159831.0,0.0010573668437286884,0.048703170028818445
509,28,211.0,3120,0,3120,160000.0,0.0,0.0
510,29,4956.0,10191,3220,6971,156780.0,0.020538333971169793,0.3159650672161711
511,30,707.0,3725,532,3193,159468.0,0.0033360925075877294,0.14281879194630873
512,31,2258.0,14494,1861,12633,158139.0,0.011768128039256604,0.1283979577756313
513,32,387.0,707,13,694,159987.0,8.125660209892054e-05,0.018387553041018388
514,34,12855.0,16712,11164,5548,148836.0,0.07500873444596737,0.6680229775011968
515,35,434.0,2552,264,2288,159736.0,0.0016527269995492563,0.10344827586206896
516,36,605.0,5034,514,4520,159486.0,0.00322285341660083,0.10210568136670639
517,39,108.0,3665,0,3665,160000.0,0.0,0.0
518,40,282.0,3379,0,3379,160000.0,0.0,0.0
519,42,4289.0,8661,3156,5505,156844.0,0.020121904567595827,0.3643921025285764
520,43,1101.0,839,0,839,160000.0,0.0,0.0
521,44,3660.0,4122,2463,1659,157537.0,0.01563442238966084,0.5975254730713246
522,45,2483.0,1637,571,1066,159429.0,0.0035815315908648993,0.3488087965791081
523,46,87.0,15807,87,15720,159913.0,0.0005440458249172988,0.005503890681343709
524,47,69.0,6050,59,5991,159941.0,0.0003688860267223539,0.009752066115702479
525,48,1181.0,9005,613,8392,159387.0,0.003845984929762151,0.06807329261521378
526,49,1023.0,10823,864,9959,159136.0,0.00542931831892218,0.07982999168437586
527,50,1218.0,12306,973,11333,159027.0,0.006118457871933697,0.07906712172923777
528,51,225.0,5666,80,5586,159920.0,0.0005002501250625312,0.014119308153900459
529,52,1235.0,17711,187,17524,159813.0,0.0011701175749156828,0.010558410027666422
530,53,3217.0,3707,1077,2630,158923.0,0.006776866784543458,0.29053142702994333
531,54,3287.0,2878,529,2349,159471.0,0.003317217550526428,0.1838082001389854
532,56,399.0,4390,1,4389,159999.0,6.250039062744142e-06,0.00022779043280182233
533,57,11823.0,13280,8857,4423,151143.0,0.058600133648266876,0.6669427710843373
534,58,747.0,9493,49,9444,159951.0,0.0003063438177941995,0.005161698093331929
535,59,515.0,1940,0,1940,160000.0,0.0,0.0
536,60,2133.0,4058,867,3191,159133.0,0.005448272828388832,0.21365204534253326
537,61,7390.0,13850,5835,8015,154165.0,0.03784905782765219,0.42129963898916967
538,62,242.0,3181,12,3169,159988.0,7.500562542190664e-05,0.003772398616787174
539,63,79.0,954,0,954,160000.0,0.0,0.0
540,64,1508.0,4067,983,3084,159017.0,0.006181728997528566,0.24170149987705924
541,65,915.0,5400,771,4629,159229.0,0.0048420827864270955,0.14277777777777778
542,66,1529.0,13577,835,12742,159165.0,0.005246128231709233,0.06150106798261766
543,67,1783.0,5389,1251,4138,158749.0,0.007880364600721895,0.2321395435145667
544,68,2359.0,15105,1622,13483,158378.0,0.010241321395648385,0.10738166170142337
545,69,400.0,2676,74,2602,159926.0,0.0004627140052274177,0.02765321375186846
546,70,1525.0,2934,355,2579,159645.0,0.0022236837984277616,0.12099522835719155
547,71,1539.0,7937,1204,6733,158796.0,0.007582054963601099,0.15169459493511403
548,72,1666.0,14290,1178,13112,158822.0,0.00741710846104444,0.08243526941917424
549,73,1311.0,10481,901,9580,159099.0,0.005663140560280077,0.08596507966797061
550,74,7440.0,11638,5037,6601,154963.0,0.0325045333402167,0.43280632411067194
551,75,4474.0,12231,2458,9773,157542.0,0.015602188622716482,0.20096476167116345
552,76,1531.0,13151,941,12210,159059.0,0.005916043732200001,0.07155349403087218
553,77,3997.0,3625,997,2628,159003.0,0.0062703219436111264,0.2750344827586207
554,78,7312.0,14524,5006,9518,154994.0,0.03229802443965573,0.3446708895621041
555,79,13070.0,31644,11875,19769,148125.0,0.08016877637130802,0.3752686133232208
556,80,23293.0,27255,19432,7823,140568.0,0.13823914404416368,0.712970097229866
557,81,3567.0,16689,2917,13772,157083.0,0.018569800678622128,0.17478578704535921
558,82,3993.0,17390,2742,14648,157258.0,0.017436314845667628,0.15767682576193215
559,83,6772.0,15314,5911,9403,154089.0,0.038360947244774124,0.3859866788559488
560,84,15498.0,17958,12934,5024,147066.0,0.08794690819088029,0.7202361064706537
561,85,12987.0,16322,8291,8031,151709.0,0.05465067992011021,0.5079647102070824
562,86,31702.0,40555,28019,12536,131981.0,0.21229570923087415,0.6908889162865245
563,87,1327.0,3148,156,2992,159844.0,0.0009759515527639448,0.04955527318932656
564,88,1455.0,9066,230,8836,159770.0,0.001439569380985166,0.025369512464151776
565,89,1558.0,1717,260,1457,159740.0,0.0016276449229998748,0.151426907396622
566,90,4441.0,15261,3198,12063,156802.0,0.02039514802107116,0.20955376449773933
567,91,413.0,702,89,613,159911.0,0.0005565595862698626,0.1267806267806268
568,92,1437.0,1797,831,966,159169.0,0.0052208658721233404,0.46243739565943237
569,93,604.0,804,42,762,159958.0,0.00026256892434263994,0.05223880597014925
570,94,14.0,2972,0,2972,160000.0,0.0,0.0
571,95,808.0,1591,287,1304,159713.0,0.0017969733208943542,0.180389692017599
572,96,3779.0,13210,2665,10545,157335.0,0.01693837989004354,0.20174110522331568
573,97,3297.0,10305,2777,7528,157223.0,0.017662810148642374,0.26948083454633676
574,98,13659.0,23273,11473,11800,148527.0,0.07724521467477294,0.4929746917028316
575,99,3868.0,8233,2658,5575,157342.0,0.016893137242440036,0.3228470788291024
576,100,11257.0,24690,9533,15157,150467.0,0.06335608472289606,0.3861077359254759
577,101,924.0,10351,854,9497,159146.0,0.005366141781760145,0.08250410588348951
578,102,208.0,8565,61,8504,159939.0,0.0003813954069989183,0.007122008172796264
579,103,322.0,5403,216,5187,159784.0,0.0013518249637009963,0.03997779011660189
580,104,658.0,6639,311,6328,159689.0,0.0019475355221712203,0.046844404277752674
581,105,94.0,26696,80,26616,159920.0,0.0005002501250625312,0.0029967036260113876
582,106,248.0,7892,11,7881,159989.0,6.875472688747351e-05,0.001393816523061328
583,107,1001.0,1710,78,1632,159922.0,0.00048773777216392993,0.0456140350877193
584,108,294.0,1045,43,1002,159957.0,0.00026882224597860673,0.04114832535885168
585,109,3821.0,9783,3112,6671,156888.0,0.019835806435163937,0.31810283144229784
586,110,1549.0,3713,1036,2677,158964.0,0.0065171988626355655,0.2790196606517641
587,111,851.0,11192,1,11191,159999.0,6.250039062744142e-06,8.934953538241601e-05
588,112,1430.0,12505,1333,11172,158667.0,0.008401242854531818,0.10659736105557777
589,113,1160.0,3216,789,2427,159211.0,0.004955687735143929,0.2453358208955224
590,114,118.0,4177,43,4134,159957.0,0.00026882224597860673,0.010294469715106535
591,115,8428.0,14817,7514,7303,152486.0,0.04927665490602416,0.5071201997705338
592,116,1369.0,2756,303,2453,159697.0,0.001897343093483284,0.10994194484760522
593,117,2503.0,1904,965,939,159035.0,0.006067846700411859,0.506827731092437
594,118,125.0,2950,0,2950,160000.0,0.0,0.0
595,119,423.0,8772,273,8499,159727.0,0.0017091662649395532,0.03112175102599179
596,120,1208.0,7199,864,6335,159136.0,0.00542931831892218,0.12001666898180303
597,121,1370.0,490,55,435,159945.0,0.000343868204695364,0.11224489795918367
598,122,1368.0,13969,955,13014,159045.0,0.0060045898959414,0.0683656668337032
599,123,388.0,1999,69,1930,159931.0,0.0004314360567994948,0.03451725862931466
600,124,702.0,17705,621,17084,159379.0,0.003896372796918038,0.035074837616492514
601,125,168.0,2354,23,2331,159977.0,0.00014377066703338606,0.009770603228547154
602,126,43.0,9329,43,9286,159957.0,0.00026882224597860673,0.004609282881337764
603,127,226.0,862,0,862,160000.0,0.0,0.0
604,128,2534.0,6050,2035,4015,157965.0,0.012882600576076979,0.33636363636363636
605,129,162.0,2894,72,2822,159928.0,0.0004502025911660247,0.0248790601243953
606,130,1741.0,360,96,264,159904.0,0.0006003602161296778,0.26666666666666666
607,131,3984.0,13724,2862,10862,157138.0,0.018213290228970714,0.2085397843194404
608,132,1439.0,22542,1184,21358,158816.0,0.007455168245013097,0.05252417709165114
609,133,1226.0,53,0,53,160000.0,0.0,0.0
610,134,502.0,10286,277,10009,159723.0,0.0017342524245099328,0.026929807505347073
611,135,1479.0,135,120,15,159880.0,0.0007505629221916438,0.8888888888888888
612,136,5231.0,6710,3163,3547,156837.0,0.020167434980266137,0.4713859910581222
613,137,251.0,9606,186,9420,159814.0,0.00116385297908819,0.019362898188632106
614,138,841.0,9268,544,8724,159456.0,0.0034115994380895043,0.0586965904186448
615,139,9.0,367,0,367,160000.0,0.0,0.0
616,140,8878.0,19656,6576,13080,153424.0,0.04286161226405256,0.33455433455433453
617,141,3285.0,11604,2049,9555,157951.0,0.012972377509480788,0.1765770423991727
618,142,902.0,3905,403,3502,159597.0,0.002525110121117565,0.10320102432778488
619,143,1490.0,7444,568,6876,159432.0,0.003562647398263837,0.07630306286942504
620,144,4774.0,13887,3259,10628,156741.0,0.02079226239465105,0.23467991646863973
621,145,28.0,19,0,19,160000.0,0.0,0.0
622,146,3963.0,9914,3545,6369,156455.0,0.022658272346681153,0.3575751462578172
623,147,27.0,2033,0,2033,160000.0,0.0,0.0
624,148,696.0,875,137,738,159863.0,0.0008569837923722187,0.15657142857142858
625,151,423.0,555,10,545,159990.0,6.250390649415588e-05,0.018018018018018018
626,152,17.0,1064,0,1064,160000.0,0.0,0.0
627,153,705.0,6644,470,6174,159530.0,0.0029461543283394974,0.07074051776038531
628,154,30.0,5521,12,5509,159988.0,7.500562542190664e-05,0.0021735192899836986
629,156,176.0,11226,0,11226,160000.0,0.0,0.0
630,158,120.0,789,0,789,160000.0,0.0,0.0
631,159,1578.0,3096,885,2211,159115.0,0.005562014894887345,0.2858527131782946
632,160,1702.0,2115,741,1374,159259.0,0.004652798271997187,0.350354609929078
633,161,1000.0,3609,277,3332,159723.0,0.0017342524245099328,0.07675256303685231
634,162,72.0,4509,0,4509,160000.0,0.0,0.0
635,163,1395.0,4118,951,3167,159049.0,0.005979289401379449,0.2309373482272948
636,164,931.0,1084,0,1084,160000.0,0.0,0.0
637,165,2129.0,775,129,646,159871.0,0.0008069005635793859,0.1664516129032258
638,168,620.0,1743,31,1712,159969.0,0.00019378754633710282,0.01778542742398164
639,169,390.0,569,11,558,159989.0,6.875472688747351e-05,0.019332161687170474
640,170,433.0,2805,152,2653,159848.0,0.0009509033581902807,0.05418894830659537
641,171,20.0,412,0,412,160000.0,0.0,0.0
642,172,109.0,743,0,743,160000.0,0.0,0.0
643,173,199.0,3188,60,3128,159940.0,0.0003751406777541578,0.018820577164366373
644,174,25085.0,29471,20979,8492,139021.0,0.15090525891771747,0.7118523294085711
645,175,22880.0,36014,20117,15897,139883.0,0.14381304375799775,0.5585883267618148
646,176,1756.0,2666,732,1934,159268.0,0.0045960268227139165,0.2745686421605401
647,177,105.0,7940,0,7940,160000.0,0.0,0.0
648,178,424.0,1079,0,1079,160000.0,0.0,0.0
649,179,3780.0,5793,2322,3471,157678.0,0.014726214183335659,0.40082858622475404
650,180,3025.0,8323,2335,5988,157665.0,0.014809881711223162,0.2805478793704193
651,181,869.0,2690,474,2216,159526.0,0.0029713024836076876,0.1762081784386617
652,182,8338.0,11029,6356,4673,153644.0,0.04136835802244149,0.5762988484903436
653,183,1339.0,4213,436,3777,159564.0,0.0027324459151186983,0.10348920009494422
654,184,1280.0,7950,472,7478,159528.0,0.002958728248332581,0.059371069182389935
655,185,4094.0,4622,1900,2722,158100.0,0.012017710309930424,0.4110774556469061
656,186,4475.0,5473,2436,3037,157564.0,0.015460384351755478,0.44509409830074914
657,187,6006.0,7472,3736,3736,156264.0,0.02390825782009932,0.5
658,188,1511.0,1492,83,1409,159917.0,0.0005190192412313888,0.05563002680965148
659,189,4591.0,9275,2441,6834,157559.0,0.015492609117854264,0.26318059299191376
660,190,22783.0,30337,19307,11030,140693.0,0.13722786492576033,0.636417575897419
661,191,13746.0,16880,11527,5353,148473.0,0.07763701144315802,0.6828791469194313
662,192,3198.0,17443,1562,15881,158438.0,0.009858746007902144,0.08954881614401193
663,193,4072.0,9475,2244,7231,157756.0,0.014224498592763509,0.23683377308707124
664,194,7954.0,9336,3651,5685,156349.0,0.02335160442343731,0.3910668380462725
665,195,7374.0,18647,4062,14585,155938.0,0.026048814272339006,0.21783664932696947
666,196,4178.0,5378,3040,2338,156960.0,0.019367991845056064,0.5652658981033841
667,197,14163.0,15021,9831,5190,150169.0,0.06546624136805865,0.6544837227880966
668,198,8257.0,11991,6756,5235,153244.0,0.044086554775390877,0.5634225669251939
669,199,17344.0,18909,13021,5888,146979.0,0.08859088713353608,0.6886138875667671
670,200,130.0,293,12,281,159988.0,7.500562542190664e-05,0.040955631399317405
671,201,545.0,1507,7,1500,159993.0,4.37519141462439e-05,0.0046449900464499
672,202,656.0,125,45,80,159955.0,0.00028132912381607326,0.36
673,203,16276.0,20618,14135,6483,145865.0,0.09690467212833785,0.6855660102822776
674,204,13922.0,16695,11115,5580,148885.0,0.0746549350169594,0.6657681940700808
675,205,902.0,1145,425,720,159575.0,0.002663324455585148,0.37117903930131
676,206,4785.0,13931,3508,10423,156492.0,0.02241648135367942,0.25181250448639725
677,208,75.0,1045,0,1045,160000.0,0.0,0.0
678,209,702.0,2208,52,2156,159948.0,0.0003251056593392853,0.02355072463768116
679,210,1372.0,9452,571,8881,159429.0,0.0035815315908648993,0.06041049513330512
680,211,825.0,5100,553,4547,159447.0,0.0034682370944577193,0.1084313725490196
681,212,403.0,2074,288,1786,159712.0,0.0018032458425165298,0.13886210221793635
682,213,1550.0,3671,970,2701,159030.0,0.006099478085895743,0.2642331789703078
683,214,122.0,782,0,782,160000.0,0.0,0.0
684,215,1144.0,3479,800,2679,159200.0,0.005025125628140704,0.22995113538373096
685,216,914.0,4060,691,3369,159309.0,0.004337482502557922,0.17019704433497537
686,217,946.0,12440,279,12161,159721.0,0.0017467959754822473,0.02242765273311897
687,218,2436.0,1589,951,638,159049.0,0.005979289401379449,0.5984896161107615
688,219,4787.0,7214,3145,4069,156855.0,0.02005036498677122,0.4359578597172165
689,220,898.0,14623,832,13791,159168.0,0.005227181342983514,0.056896669630034875
690,221,91.0,6828,0,6828,160000.0,0.0,0.0
691,222,303.0,532,0,532,160000.0,0.0,0.0
692,223,332.0,1997,32,1965,159968.0,0.00020004000800160032,0.01602403605408112
693,224,190.0,278,0,278,160000.0,0.0,0.0
694,225,32.0,177,0,177,160000.0,0.0,0.0
695,226,239.0,11,0,11,160000.0,0.0,0.0
696,227,6684.0,12453,5724,6729,154276.0,0.037102336073012006,0.4596482775234883
697,228,815.0,689,0,689,160000.0,0.0,0.0
698,229,2918.0,6390,2104,4286,157896.0,0.013325226731519481,0.329264475743349
699,230,1809.0,16774,478,16296,159522.0,0.0029964519000514034,0.028496482651722905
700,231,3941.0,13143,3031,10112,156969.0,0.019309545196822302,0.2306170585102336
701,232,888.0,778,88,690,159912.0,0.0005503026664665567,0.11311053984575835
702,233,524.0,10127,0,10127,160000.0,0.0,0.0
703,234,4816.0,12000,3328,8672,156672.0,0.021241830065359478,0.2773333333333333
704,235,4988.0,7373,3492,3881,156508.0,0.022311958494134487,0.47361996473619966
705,236,1.0,4710,0,4710,160000.0,0.0,0.0
706,237,639.0,1398,207,1191,159793.0,0.0012954259573322987,0.148068669527897
707,238,576.0,4990,364,4626,159636.0,0.0022801874263950485,0.07294589178356714
708,239,529.0,2883,329,2554,159671.0,0.002060486876139061,0.11411723898716615
709,240,1056.0,2056,835,1221,159165.0,0.005246128231709233,0.4061284046692607
710,241,3703.0,8694,2213,6481,157787.0,0.014025236553074714,0.2545433632390154
711,242,1000.0,130,17,113,159983.0,0.00010626129026209034,0.13076923076923078
712,243,57.0,1649,0,1649,160000.0,0.0,0.0
713,244,91.0,2439,0,2439,160000.0,0.0,0.0
714,245,93.0,2123,0,2123,160000.0,0.0,0.0
715,247,1318.0,4832,1108,3724,158892.0,0.006973290033481862,0.2293046357615894
716,248,13.0,1528,0,1528,160000.0,0.0,0.0
717,250,444.0,4162,213,3949,159787.0,0.001333024588984085,0.05117731859682845
718,251,480.0,2070,388,1682,159612.0,0.00243089492018144,0.18743961352657004
719,252,86.0,2194,0,2194,160000.0,0.0,0.0
720,253,4010.0,10200,3031,7169,156969.0,0.019309545196822302,0.29715686274509806
721,254,1505.0,227,183,44,159817.0,0.0011450596619883991,0.8061674008810573
722,255,794.0,5562,100,5462,159900.0,0.0006253908692933083,0.017979144192736426
723,256,5624.0,15173,4534,10639,155466.0,0.02916393294996977,0.2988202728530943
724,257,687.0,6081,374,5707,159626.0,0.0023429767080550786,0.061503042262785725
725,258,328.0,1325,121,1204,159879.0,0.000756822346899843,0.09132075471698113
726,259,213.0,4824,140,4684,159860.0,0.00087576629550857,0.02902155887230514
727,260,249.0,2670,0,2670,160000.0,0.0,0.0
728,261,52.0,965,0,965,160000.0,0.0,0.0
729,262,98.0,14733,60,14673,159940.0,0.0003751406777541578,0.004072490327835471
730,264,120.0,9272,23,9249,159977.0,0.00014377066703338606,0.0024805867126833476
731,265,48.0,1966,0,1966,160000.0,0.0,0.0
732,0,527.0,1388,0,1388,160000.0,0.0,0.0
733,2,1494.0,2359,778,1581,159222.0,0.00488625943651003,0.3298007630351844
734,3,1047.0,3159,65,3094,159935.0,0.0004064151061368681,0.0205761316872428
735,4,165.0,1778,0,1778,160000.0,0.0,0.0
736,5,1480.0,3250,51,3199,159949.0,0.0003188516339583242,0.015692307692307693
737,7,76.0,6184,0,6184,160000.0,0.0,0.0
738,9,168.0,8107,0,8107,160000.0,0.0,0.0
739,11,174.0,10894,30,10864,159970.0,0.00018753516284303307,0.002753809436387002
740,12,400.0,879,45,834,159955.0,0.00028132912381607326,0.051194539249146756
741,14,15.0,0,0,0,160000.0,0.0,0.0
742,15,881.0,6369,169,6200,159831.0,0.0010573668437286884,0.02653477783011462
743,16,347.0,5037,198,4839,159802.0,0.0012390333037133453,0.039309112567004166
744,17,469.0,8752,298,8454,159702.0,0.001865975379143655,0.03404936014625228
745,18,1284.0,4100,879,3221,159121.0,0.005524098013461454,0.21439024390243902
746,19,239.0,2149,143,2006,159857.0,0.0008945495036188593,0.0665425779432294
747,20,1303.0,2496,623,1873,159377.0,0.003908970554095007,0.24959935897435898
748,23,100.0,4800,0,4800,160000.0,0.0,0.0
749,24,7442.0,10240,6289,3951,153711.0,0.04091444333847285,0.61416015625
750,25,1447.0,4588,257,4331,159743.0,0.0016088341899175552,0.056015693112467305
751,26,1010.0,4672,629,4043,159371.0,0.0039467657227475516,0.1346318493150685
752,27,548.0,5263,302,4961,159698.0,0.001891069393480194,0.05738172145164355
753,28,211.0,6071,0,6071,160000.0,0.0,0.0
754,29,4956.0,11976,3409,8567,156591.0,0.02177008895785837,0.28465263861055445
755,30,707.0,3664,532,3132,159468.0,0.0033360925075877294,0.14519650655021835
756,31,2258.0,14863,1841,13022,158159.0,0.011640184877243786,0.12386463028998183
757,32,387.0,1440,115,1325,159885.0,0.0007192669731369422,0.0798611111111111
758,34,12855.0,16839,11202,5637,148798.0,0.07528326993642388,0.6652414038838411
759,35,434.0,1545,180,1365,159820.0,0.0011262670504317356,0.11650485436893204
760,36,605.0,5409,517,4892,159483.0,0.0032417248233354025,0.09558143834350157
761,39,108.0,2932,0,2932,160000.0,0.0,0.0
762,40,282.0,4945,6,4939,159994.0,3.7501406302736355e-05,0.0012133468149646107
763,42,4289.0,9772,3235,6537,156765.0,0.020635983797403758,0.3310478919361441
764,43,1101.0,763,0,763,160000.0,0.0,0.0
765,44,3660.0,5586,2574,3012,157426.0,0.016350539301004916,0.4607948442534909
766,45,2483.0,7918,1146,6772,158854.0,0.007214171503393053,0.14473351856529426
767,46,87.0,15210,87,15123,159913.0,0.0005440458249172988,0.005719921104536489
768,47,69.0,5148,51,5097,159949.0,0.0003188516339583242,0.009906759906759906
769,48,1181.0,8488,557,7931,159443.0,0.0034934114385705237,0.06562205466540999
770,49,1023.0,10648,868,9780,159132.0,0.005454591157026871,0.08151765589782119
771,50,1218.0,13988,982,13006,159018.0,0.006175401526871172,0.07020303116957392
772,51,225.0,3919,21,3898,159979.0,0.00013126722882378313,0.0053585098239346774
773,52,1235.0,4998,0,4998,160000.0,0.0,0.0
774,53,3217.0,3402,973,2429,159027.0,0.006118457871933697,0.28600823045267487
775,54,3287.0,4706,667,4039,159333.0,0.004186201226362398,0.14173395665108374
776,56,399.0,3945,1,3944,159999.0,6.250039062744142e-06,0.00025348542458808617
777,57,11823.0,13069,8751,4318,151249.0,0.057858233773446434,0.6695998163593236
778,58,747.0,8609,34,8575,159966.0,0.00021254516584774265,0.003949355325821815
779,59,515.0,3061,0,3061,160000.0,0.0,0.0
780,60,2133.0,5552,1054,4498,158946.0,0.006631182917468826,0.1898414985590778
781,61,7390.0,11562,5486,6076,154514.0,0.03550487334481018,0.47448538315170385
782,62,242.0,2715,23,2692,159977.0,0.00014377066703338606,0.00847145488029466
783,63,79.0,1945,0,1945,160000.0,0.0,0.0
784,64,1508.0,3950,963,2987,159037.0,0.0060551947031194,0.2437974683544304
785,65,915.0,6226,798,5428,159202.0,0.005012499842966797,0.12817218117571474
786,66,1529.0,16026,893,15133,159107.0,0.0056125751852526915,0.05572195182827905
787,67,1783.0,7614,1260,6354,158740.0,0.00793750787451178,0.16548463356973994
788,68,2359.0,16981,1604,15377,158396.0,0.01012651834642289,0.09445851245509687
789,69,400.0,786,58,728,159942.0,0.00036263145390203947,0.0737913486005089
790,70,1525.0,915,164,751,159836.0,0.0010260517029955704,0.17923497267759564
791,71,1539.0,7438,1155,6283,158845.0,0.00727123925839655,0.15528367840817425
792,72,1666.0,15002,1192,13810,158808.0,0.007505919097274697,0.07945607252366352
793,73,1311.0,9996,835,9161,159165.0,0.005246128231709233,0.08353341336534614
794,74,7440.0,8861,4303,4558,155697.0,0.027637012916112706,0.48561110484144004
795,75,4474.0,11956,2378,9578,157622.0,0.015086726472192969,0.1988959518233523
796,76,1531.0,9881,859,9022,159141.0,0.005397729057879491,0.08693452079749013
797,77,3997.0,2894,935,1959,159065.0,0.005878100147738346,0.3230822391154112
798,78,7312.0,14198,5201,8997,154799.0,0.033598408258451284,0.36631919988730804
799,79,13070.0,34825,11931,22894,148069.0,0.08057729842168178,0.3425987078248385
800,80,23293.0,28510,19718,8792,140282.0,0.14055972968734406,0.6916169764994738
801,81,3567.0,14695,2733,11962,157267.0,0.017378089491120196,0.18598162640353863
802,82,3993.0,16781,2603,14178,157397.0,0.01653779932273169,0.15511590489243787
803,83,6772.0,19429,6205,13224,153795.0,0.04034591501674307,0.3193679551186371
804,84,15498.0,19757,13158,6599,146842.0,0.08960651584696476,0.6659918003745507
805,85,12987.0,16608,8416,8192,151584.0,0.055520371543170785,0.5067437379576107
806,86,31702.0,41035,28173,12862,131827.0,0.21371191030668982,0.6865602534421835
807,87,1327.0,3148,161,2987,159839.0,0.0010072635589561997,0.051143583227446
808,88,1455.0,7226,193,7033,159807.0,0.0012077067963230648,0.026709106006089122
809,89,1558.0,896,91,805,159909.0,0.0005690736606444916,0.1015625
810,90,4441.0,11317,2993,8324,157007.0,0.019062844331781386,0.2644693823451445
811,91,413.0,862,85,777,159915.0,0.0005315323765750555,0.09860788863109049
812,92,1437.0,2091,852,1239,159148.0,0.005353507427049036,0.40746054519368724
813,93,604.0,228,52,176,159948.0,0.0003251056593392853,0.22807017543859648
814,94,14.0,2767,0,2767,160000.0,0.0,0.0
815,95,808.0,1571,281,1290,159719.0,0.0017593398405950451,0.17886696371737745
816,96,3779.0,9152,2400,6752,157600.0,0.015228426395939087,0.26223776223776224
817,97,3297.0,8608,2713,5895,157287.0,0.017248723670742018,0.31517193308550184
818,98,13659.0,19721,10548,9173,149452.0,0.07057784439151031,0.5348613153491202
819,99,3868.0,6831,2547,4284,157453.0,0.016176255771563577,0.37285902503293805
820,100,11257.0,20955,8891,12064,151109.0,0.0588383220059692,0.42429014554998806
821,101,924.0,4237,296,3941,159704.0,0.0018534288433602164,0.06986075053103612
822,102,208.0,4986,52,4934,159948.0,0.0003251056593392853,0.010429201764941836
823,103,322.0,10418,219,10199,159781.0,0.0013706260443982702,0.021021309272413132
824,104,658.0,7059,304,6755,159696.0,0.0019036168720569081,0.04306559002691599
825,105,94.0,33024,83,32941,159917.0,0.0005190192412313888,0.002513323643410853
826,106,248.0,1800,8,1792,159992.0,5.000250012500625e-05,0.0044444444444444444
827,107,1001.0,5743,142,5601,159858.0,0.0008882883559158753,0.024725753090719137
828,108,294.0,2014,75,1939,159925.0,0.0004689698296076286,0.03723932472691162
829,109,3821.0,7557,3099,4458,156901.0,0.019751308149724985,0.4100833664152441
830,110,1549.0,3456,1020,2436,158980.0,0.006415901371241666,0.2951388888888889
831,111,851.0,8500,1,8499,159999.0,6.250039062744142e-06,0.00011764705882352942
832,112,1430.0,7218,1307,5911,158693.0,0.00823602805416748,0.18107509005264616
833,113,1160.0,3216,786,2430,159214.0,0.004936751793184016,0.24440298507462688
834,114,118.0,3414,31,3383,159969.0,0.00019378754633710282,0.00908025776215583
835,115,8428.0,14359,7482,6877,152518.0,0.049056504805990116,0.5210669266662024
836,116,1369.0,2936,214,2722,159786.0,0.001339291302116581,0.07288828337874659
837,117,2503.0,1854,972,882,159028.0,0.006112131197021908,0.5242718446601942
838,118,125.0,2410,0,2410,160000.0,0.0,0.0
839,119,423.0,10125,293,9832,159707.0,0.0018346096288828918,0.02893827160493827
840,120,1208.0,5766,790,4976,159210.0,0.00496199987437975,0.1370100589663545
841,121,1370.0,1244,105,1139,159895.0,0.0006566809468713843,0.08440514469453377
842,122,1368.0,12913,883,12030,159117.0,0.005549375616684578,0.06838070161852397
843,123,388.0,2217,82,2135,159918.0,0.0005127627909303518,0.03698691926026162
844,124,702.0,6962,619,6343,159381.0,0.0038837753559081696,0.08891123240448147
845,125,168.0,913,27,886,159973.0,0.00016877848136873097,0.029572836801752465
846,126,43.0,9733,43,9690,159957.0,0.00026882224597860673,0.0044179595191616156
847,127,226.0,599,0,599,160000.0,0.0,0.0
848,128,2534.0,6596,2055,4541,157945.0,0.01301085821013644,0.31155245603396
849,129,162.0,3284,75,3209,159925.0,0.0004689698296076286,0.022838002436053592
850,130,1741.0,243,76,167,159924.0,0.00047522573222280584,0.31275720164609055
851,131,3984.0,14964,2988,11976,157012.0,0.019030392581458742,0.1996792301523657
852,132,1439.0,17369,1153,16216,158847.0,0.007258556976209812,0.06638263573032414
853,133,1226.0,585,0,585,160000.0,0.0,0.0
854,134,502.0,2953,160,2793,159840.0,0.001001001001001001,0.054182187605824585
855,135,1479.0,56,46,10,159954.0,0.0002875826800205059,0.8214285714285714
856,136,5231.0,7266,3446,3820,156554.0,0.022011574281078732,0.4742636939168731
857,137,251.0,11603,188,11415,159812.0,0.0011763822491427428,0.016202706196673276
858,138,841.0,8576,425,8151,159575.0,0.002663324455585148,0.049556902985074626
859,139,9.0,1118,0,1118,160000.0,0.0,0.0
860,140,8878.0,20080,6644,13436,153356.0,0.043324030360729286,0.3308764940239044
861,141,3285.0,7824,1503,6321,158497.0,0.0094828293279999,0.19210122699386503
862,142,902.0,3714,384,3330,159616.0,0.0024057738572574178,0.10339256865912763
863,143,1490.0,6664,528,6136,159472.0,0.00331092605598475,0.07923169267707082
864,144,4774.0,16134,3441,12693,156559.0,0.02197893445921346,0.21327631089624396
865,145,28.0,0,0,0,160000.0,0.0,0.0
866,146,3963.0,9629,3534,6095,156466.0,0.02258637659299784,0.36701630491224424
867,147,27.0,1552,0,1552,160000.0,0.0,0.0
868,148,696.0,1049,150,899,159850.0,0.0009383797309978105,0.14299332697807435
869,151,423.0,876,63,813,159937.0,0.0003939051001331774,0.07191780821917808
870,152,17.0,733,0,733,160000.0,0.0,0.0
871,153,705.0,4701,474,4227,159526.0,0.0029713024836076876,0.10082961072112316
872,154,30.0,5542,6,5536,159994.0,3.7501406302736355e-05,0.0010826416456153013
873,156,176.0,7621,0,7621,160000.0,0.0,0.0
874,158,120.0,430,0,430,160000.0,0.0,0.0
875,159,1578.0,1832,777,1055,159223.0,0.004879948248682665,0.42412663755458513
876,160,1702.0,2262,745,1517,159255.0,0.00467803208690465,0.32935455349248455
877,161,1000.0,3691,381,3310,159619.0,0.002386933886316792,0.1032240585207261
878,162,72.0,5809,0,5809,160000.0,0.0,0.0
879,163,1395.0,4146,896,3250,159104.0,0.0056315366049879325,0.2161119150988905
880,164,931.0,1775,5,1770,159995.0,3.125097659301853e-05,0.0028169014084507044
881,165,2129.0,740,130,610,159870.0,0.0008131606930631138,0.17567567567567569
882,168,620.0,762,9,753,159991.0,5.625316424048853e-05,0.011811023622047244
883,169,390.0,754,16,738,159984.0,0.00010001000100010001,0.021220159151193633
884,170,433.0,3122,125,2997,159875.0,0.0007818608287724785,0.04003843689942345
885,171,20.0,394,0,394,160000.0,0.0,0.0
886,172,109.0,483,0,483,160000.0,0.0,0.0
887,173,199.0,3221,53,3168,159947.0,0.00033135976292146774,0.016454517230673704
888,174,25085.0,28118,20559,7559,139441.0,0.14743870167310905,0.7311686464186642
889,175,22880.0,35277,19806,15471,140194.0,0.14127566086993737,0.5614422995152649
890,176,1756.0,3709,585,3124,159415.0,0.003669667220775962,0.15772445403073604
891,177,105.0,6328,0,6328,160000.0,0.0,0.0
892,178,424.0,1500,0,1500,160000.0,0.0,0.0
893,179,3780.0,6442,2300,4142,157700.0,0.014584654407102092,0.3570319776466936
894,180,3025.0,5940,2011,3929,157989.0,0.01272873427896879,0.33855218855218855
895,181,869.0,3105,518,2587,159482.0,0.003248015450019438,0.16682769726247987
896,182,8338.0,10752,6333,4419,153667.0,0.04121249194687213,0.5890066964285714
897,183,1339.0,3308,393,2915,159607.0,0.0024622980195104223,0.11880290205562273
898,184,1280.0,9589,492,9097,159508.0,0.0030844847907314996,0.05130879132339138
899,185,4094.0,8261,2582,5679,157418.0,0.016402190346720198,0.31255295969011015
900,186,4475.0,6879,2576,4303,157424.0,0.01636345157028153,0.37447303387120223
901,187,6006.0,5726,3580,2146,156420.0,0.022887098836465926,0.6252183024799162
902,188,1511.0,594,0,594,160000.0,0.0,0.0
903,189,4591.0,5162,1836,3326,158164.0,0.011608204142535597,0.35567609453700116
904,190,22783.0,29650,19273,10377,140727.0,0.13695310779026057,0.6500168634064081
905,191,13746.0,17174,11557,5617,148443.0,0.07785479948532434,0.6729358332362874
906,192,3198.0,14514,1494,13020,158506.0,0.009425510706219322,0.10293509714758164
907,193,4072.0,8744,2211,6533,157789.0,0.014012383626235036,0.2528591033851784
908,194,7954.0,11093,3878,7215,156122.0,0.02483954855817886,0.3495898314252231
909,195,7374.0,16363,3386,12977,156614.0,0.02162003396886613,0.20693026951048096
910,196,4178.0,4940,3002,1938,156998.0,0.019121262691244475,0.6076923076923076
911,197,14163.0,15816,10234,5582,149766.0,0.06833326656250417,0.6470662620131512
912,198,8257.0,11253,6785,4468,153215.0,0.044284175831348103,0.602950324357949
913,199,17344.0,18263,12821,5442,147179.0,0.0871116123903546,0.7020204785632153
914,200,130.0,834,36,798,159964.0,0.00022505063639318847,0.04316546762589928
915,201,545.0,1754,27,1727,159973.0,0.00016877848136873097,0.01539338654503991
916,202,656.0,104,37,67,159963.0,0.00023130348893181548,0.3557692307692308
917,203,16276.0,20659,14030,6629,145970.0,0.09611564020004111,0.6791229004308049
918,204,13922.0,16304,10961,5343,149039.0,0.07354450848435644,0.6722890088321885
919,205,902.0,1299,456,843,159544.0,0.0028581457152885726,0.3510392609699769
920,206,4785.0,8098,3117,4981,156883.0,0.019868309504535227,0.3849098542850086
921,208,75.0,1248,0,1248,160000.0,0.0,0.0
922,209,702.0,3819,140,3679,159860.0,0.00087576629550857,0.036658811207122284
923,210,1372.0,8506,564,7942,159436.0,0.0035374695802704533,0.0663061368445803
924,211,825.0,5150,548,4602,159452.0,0.0034367709404711138,0.10640776699029127
925,212,403.0,2627,299,2328,159701.0,0.0018722487648793684,0.11381804339550819
926,213,1550.0,6058,664,5394,159336.0,0.0041672942712255865,0.10960713106635854
927,214,122.0,1927,0,1927,160000.0,0.0,0.0
928,215,1144.0,3631,822,2809,159178.0,0.005164030205179108,0.22638391627650786
929,216,914.0,5194,771,4423,159229.0,0.0048420827864270955,0.14844050827878322
930,217,946.0,10990,267,10723,159733.0,0.0016715393813426156,0.02429481346678799
931,218,2436.0,4867,1107,3760,158893.0,0.006966952603324249,0.2274501746455722
932,219,4787.0,7426,3192,4234,156808.0,0.020356104280393857,0.4298410988419068
933,220,898.0,12817,733,12084,159267.0,0.004602334444674666,0.057189669969571665
934,221,91.0,7860,0,7860,160000.0,0.0,0.0
935,222,303.0,174,0,174,160000.0,0.0,0.0
936,223,332.0,2567,41,2526,159959.0,0.0002563156808932289,0.01597195169458512
937,224,190.0,234,0,234,160000.0,0.0,0.0
938,225,32.0,260,0,260,160000.0,0.0,0.0
939,226,239.0,1,0,1,160000.0,0.0,0.0
940,227,6684.0,12104,5757,6347,154243.0,0.03732422216891528,0.47562789160608065
941,228,815.0,587,0,587,160000.0,0.0,0.0
942,229,2918.0,5354,2009,3345,157991.0,0.01271591419764417,0.37523347030257753
943,230,1809.0,15192,358,14834,159642.0,0.0022425176332042944,0.023565034228541337
944,231,3941.0,16082,3162,12920,156838.0,0.020160930386768514,0.19661733615221988
945,232,888.0,599,80,519,159920.0,0.0005002501250625312,0.1335559265442404
946,233,524.0,11372,0,11372,160000.0,0.0,0.0
947,234,4816.0,12175,3218,8957,156782.0,0.020525315406105294,0.26431211498973306
948,235,4988.0,7758,3592,4166,156408.0,0.02296557720832694,0.4630059293632379
949,236,1.0,4373,0,4373,160000.0,0.0,0.0
950,237,639.0,2433,212,2221,159788.0,0.0013267579542894335,0.08713522400328812
951,238,576.0,4550,362,4188,159638.0,0.002267630514038011,0.07956043956043957
952,239,529.0,3969,317,3652,159683.0,0.0019851831441042565,0.07986898463088939
953,240,1056.0,2581,872,1709,159128.0,0.005479865265698054,0.33785354513754356
954,241,3703.0,7088,2102,4986,157898.0,0.013312391543908092,0.29655756207674944
955,242,1000.0,299,0,299,160000.0,0.0,0.0
956,243,57.0,1138,0,1138,160000.0,0.0,0.0
957,244,91.0,1974,0,1974,160000.0,0.0,0.0
958,245,93.0,898,0,898,160000.0,0.0,0.0
959,247,1318.0,3918,1091,2827,158909.0,0.006865564568400783,0.2784583971413987
960,248,13.0,987,0,987,160000.0,0.0,0.0
961,250,444.0,3147,172,2975,159828.0,0.0010761568686337812,0.05465522720050842
962,251,480.0,2230,396,1834,159604.0,0.0024811408235382573,0.17757847533632287
963,252,86.0,7857,0,7857,160000.0,0.0,0.0
964,253,4010.0,12850,3138,9712,156862.0,0.02000484502301386,0.24420233463035018
965,254,1505.0,274,158,116,159842.0,0.0009884761201686665,0.5766423357664233
966,255,794.0,5135,125,5010,159875.0,0.0007818608287724785,0.024342745861733205
967,256,5624.0,15124,4540,10584,155460.0,0.02920365367297054,0.30018513620735254
968,257,687.0,2532,226,2306,159774.0,0.0014144979783944822,0.08925750394944708
969,258,328.0,1643,166,1477,159834.0,0.001038577524181338,0.101034692635423
970,259,213.0,4894,109,4785,159891.0,0.0006817144179472266,0.022272170004086638
971,260,249.0,3133,0,3133,160000.0,0.0,0.0
972,261,52.0,382,0,382,160000.0,0.0,0.0
973,262,98.0,14259,60,14199,159940.0,0.0003751406777541578,0.004207868714496108
974,264,120.0,7508,23,7485,159977.0,0.00014377066703338606,0.003063399041022909
975,265,48.0,1562,0,1562,160000.0,0.0,0.0
976,0,527.0,326,0,326,160000.0,0.0,0.0
977,2,1494.0,1963,716,1247,159284.0,0.0044951156425001885,0.3647478349465104
978,3,1047.0,3824,185,3639,159815.0,0.001157588461658793,0.04837866108786611
979,4,165.0,4268,0,4268,160000.0,0.0,0.0
980,5,1480.0,1390,42,1348,159958.0,0.00026256892434263994,0.030215827338129497
981,7,76.0,5723,0,5723,160000.0,0.0,0.0
982,9,168.0,8758,0,8758,160000.0,0.0,0.0
983,11,174.0,9146,14,9132,159986.0,8.75076569199805e-05,0.0015307238136890444
984,12,400.0,1268,50,1218,159950.0,0.00031259768677711783,0.03943217665615142
985,14,15.0,94,0,94,160000.0,0.0,0.0
986,15,881.0,7706,207,7499,159793.0,0.0012954259573322987,0.026862185310147935
987,16,347.0,8690,249,8441,159751.0,0.0015586756890410701,0.028653624856156502
988,17,469.0,8583,293,8290,159707.0,0.0018346096288828918,0.0341372480484679
989,18,1284.0,4345,902,3443,159098.0,0.005669461589712001,0.20759493670886076
990,19,239.0,2906,142,2764,159858.0,0.0008882883559158753,0.048864418444597386
991,20,1303.0,2464,619,1845,159381.0,0.0038837753559081696,0.2512175324675325
992,23,100.0,3649,0,3649,160000.0,0.0,0.0
993,24,7442.0,9937,6167,3770,153833.0,0.040088927603310086,0.6206098420046292
994,25,1447.0,5821,374,5447,159626.0,0.0023429767080550786,0.06425012884384126
995,26,1010.0,4518,612,3906,159388.0,0.0038396868020177176,0.13545816733067728
996,27,548.0,6157,356,5801,159644.0,0.0022299616647039663,0.05782036706188078
997,28,211.0,1587,0,1587,160000.0,0.0,0.0
998,29,4956.0,12436,3452,8984,156548.0,0.022050744819480286,0.2775812158250241
999,30,707.0,2663,324,2339,159676.0,0.00202910894561487,0.12166729252722494
