,query_name,y_mask_size,pred_mask_size,intersection_size,wrong_pred_size,union,IOU,percent_y
0,0,527.0,26347,136,26211,159864.0,0.0008507231146474503,0.005161878012676965
1,2,1494.0,2767,863,1904,159137.0,0.005423000307910794,0.31189013371882907
2,3,1047.0,7377,664,6713,159336.0,0.0041672942712255865,0.09000948895214857
3,4,165.0,12829,61,12768,159939.0,0.0003813954069989183,0.004754852287785486
4,5,1480.0,4179,46,4133,159954.0,0.0002875826800205059,0.011007418042593921
5,7,76.0,10135,0,10135,160000.0,0.0,0.0
6,9,168.0,16406,0,16406,160000.0,0.0,0.0
7,11,174.0,17410,57,17353,159943.0,0.0003563769592917477,0.0032739804709936817
8,12,400.0,3942,215,3727,159785.0,0.0013455580936883938,0.054540842212075086
9,14,15.0,957,0,957,160000.0,0.0,0.0
10,15,881.0,16651,310,16341,159690.0,0.0019412611935625274,0.0186175004504234
11,16,347.0,18977,287,18690,159713.0,0.0017969733208943542,0.015123570638140908
12,17,469.0,17789,374,17415,159626.0,0.0023429767080550786,0.021024228455787285
13,18,1284.0,5753,981,4772,159019.0,0.006169074135795094,0.17051972883712846
14,19,239.0,19659,223,19436,159777.0,0.001395695250255043,0.011343405056208353
15,20,1303.0,14887,954,13933,159046.0,0.005998264652993473,0.06408275676764963
16,23,100.0,22078,30,22048,159970.0,0.00018753516284303307,0.0013588187335809403
17,24,7442.0,8440,4305,4135,155695.0,0.027650213558560004,0.5100710900473934
18,25,1447.0,10779,605,10174,159395.0,0.0037956021205182095,0.05612765562668151
19,26,1010.0,6356,756,5600,159244.0,0.0047474316143779356,0.11894273127753303
20,27,548.0,35727,547,35180,159453.0,0.003430477946479527,0.015310549444397794
21,28,211.0,26607,93,26514,159907.0,0.0005815880480529307,0.0034953207802458
22,29,4956.0,18873,3831,15042,156169.0,0.02453111693101704,0.20298839612144334
23,30,707.0,11293,652,10641,159348.0,0.004091673569796923,0.05773488001416807
24,31,2258.0,19332,2019,17313,157981.0,0.012780017850247814,0.10443823711980137
25,32,387.0,3932,229,3703,159771.0,0.0014333014126468508,0.05824008138351984
26,34,12855.0,26562,11067,15495,148933.0,0.07430858171123929,0.416647842782923
27,35,434.0,5792,326,5466,159674.0,0.0020416598820095946,0.056284530386740333
28,36,605.0,10244,524,9720,159476.0,0.0032857608668388975,0.0511518937914877
29,39,108.0,7630,70,7560,159930.0,0.0004376914900268868,0.009174311926605505
30,40,282.0,9608,202,9406,159798.0,0.0012640959211003893,0.02102414654454621
31,42,4289.0,15802,3435,12367,156565.0,0.021939769424839523,0.21737754714593088
32,43,1101.0,3026,285,2741,159715.0,0.0017844285132892965,0.09418374091209518
33,44,3660.0,12652,2870,9782,157130.0,0.018265130783427733,0.22684160607018652
34,45,2483.0,15817,1420,14397,158580.0,0.008954470929499306,0.08977682240627173
35,46,87.0,57591,87,57504,159913.0,0.0005440458249172988,0.0015106527061520029
36,47,69.0,9393,68,9325,159932.0,0.00042518070179826424,0.007239433620781433
37,48,1181.0,19114,959,18155,159041.0,0.006029891663156041,0.0501726483206027
38,49,1023.0,11384,890,10494,159110.0,0.005593614480548049,0.07817990161630359
39,50,1218.0,19798,942,18856,159058.0,0.005922367941254134,0.04758056369330235
40,51,225.0,17939,224,17715,159776.0,0.0014019627478469858,0.012486760689001617
41,52,1235.0,18597,636,17961,159364.0,0.003990863683140483,0.034199064365220196
42,53,3217.0,9128,1840,7288,158160.0,0.01163378856853819,0.20157756354075373
43,54,3287.0,6799,842,5957,159158.0,0.005290340416441524,0.12384174143256362
44,56,399.0,2555,0,2555,160000.0,0.0,0.0
45,57,11823.0,13649,8592,5057,151408.0,0.056747331712987424,0.6294966664224485
46,58,747.0,13194,284,12910,159716.0,0.0017781562273034637,0.021524935576777322
47,59,515.0,17899,155,17744,159845.0,0.0009696893865932622,0.008659701659310575
48,60,2133.0,8827,1486,7341,158514.0,0.009374566284366049,0.16834711680072506
49,61,7390.0,18634,6459,12175,153541.0,0.0420669397750438,0.34662444993023506
50,62,242.0,12801,97,12704,159903.0,0.0006066177620182235,0.007577533005233966
51,63,79.0,12680,6,12674,159994.0,3.7501406302736355e-05,0.00047318611987381704
52,64,1508.0,18104,1214,16890,158786.0,0.007645510309473127,0.06705700397702165
53,65,915.0,23654,872,22782,159128.0,0.005479865265698054,0.03686480087934387
54,66,1529.0,31347,1176,30171,158824.0,0.0074044225054147985,0.037515551727438035
55,67,1783.0,27734,1449,26285,158551.0,0.009139015206463536,0.05224634023220596
56,68,2359.0,20119,1874,18245,158126.0,0.01185130845022324,0.09314578259356827
57,69,400.0,2841,114,2727,159886.0,0.0007130080182129767,0.04012671594508976
58,70,1525.0,5167,619,4548,159381.0,0.0038837753559081696,0.119798722663054
59,71,1539.0,12828,1319,11509,158681.0,0.008312274311354227,0.10282195198004365
60,72,1666.0,23594,1393,22201,158607.0,0.008782714508186903,0.05904043400864627
61,73,1311.0,30506,1239,29267,158761.0,0.007804183647117365,0.040614960991280404
62,74,7440.0,13265,5349,7916,154651.0,0.03458755520494533,0.4032416132679985
63,75,4474.0,18358,3058,15300,156942.0,0.01948490525162162,0.16657587972546029
64,76,1531.0,14779,1145,13634,158855.0,0.0072078310408863425,0.07747479531768049
65,77,3997.0,4856,1253,3603,158747.0,0.007893062546063862,0.2580313014827018
66,78,7312.0,22678,6417,16261,153583.0,0.041781968056360405,0.2829614604462475
67,79,13070.0,43548,12086,31462,147914.0,0.08170964208932217,0.2775328373289244
68,80,23293.0,32796,19444,13352,140556.0,0.1383363214661772,0.59287718014392
69,81,3567.0,17344,2809,14535,157191.0,0.017869979833451025,0.1619580258302583
70,82,3993.0,26784,3176,23608,156824.0,0.020252002244554406,0.11857825567502987
71,83,6772.0,35263,6418,28845,153582.0,0.04178875128595799,0.182003800017015
72,84,15498.0,33210,13057,20153,146943.0,0.08885758423334218,0.393164709424872
73,85,12987.0,20060,9007,11053,150993.0,0.059651771936447384,0.44900299102691926
74,86,31702.0,45071,28547,16524,131453.0,0.21716507040539204,0.6333784473386435
75,87,1327.0,9508,560,8948,159440.0,0.0035122930255895636,0.058897770298695834
76,88,1455.0,3602,142,3460,159858.0,0.0008882883559158753,0.039422543031649084
77,89,1558.0,6192,501,5691,159499.0,0.003141085524047173,0.0809108527131783
78,90,4441.0,18691,3206,15485,156794.0,0.02044721099021646,0.17152640308169706
79,91,413.0,13670,275,13395,159725.0,0.0017217091876663014,0.02011704462326262
80,92,1437.0,8152,1083,7069,158917.0,0.006814878206862702,0.13285083415112856
81,93,604.0,11264,245,11019,159755.0,0.0015335983224312227,0.021750710227272728
82,94,14.0,3513,0,3513,160000.0,0.0,0.0
83,95,808.0,5817,507,5310,159493.0,0.0031788228950486853,0.08715832903558535
84,96,3779.0,20091,2834,17257,157166.0,0.018031889848949517,0.14105818525708028
85,97,3297.0,20099,3048,17051,156952.0,0.01941995004842245,0.15164933578785014
86,98,13659.0,25564,11607,13957,148393.0,0.07821797524141974,0.4540369269284932
87,99,3868.0,7157,2476,4681,157524.0,0.015718239760290496,0.3459550090820176
88,100,11257.0,35826,10557,25269,149443.0,0.07064231847594066,0.29467425891810417
89,101,924.0,13083,833,12250,159167.0,0.005233496893200224,0.06367041198501873
90,102,208.0,13402,114,13288,159886.0,0.0007130080182129767,0.00850619310550664
91,103,322.0,19289,283,19006,159717.0,0.0017718840198601277,0.014671574472497279
92,104,658.0,9053,378,8675,159622.0,0.0023680946235481327,0.041754114658124376
93,105,94.0,34328,87,34241,159913.0,0.0005440458249172988,0.002534374271731531
94,106,248.0,18452,106,18346,159894.0,0.000662939197218157,0.0057446347279427705
95,107,1001.0,4239,234,4005,159766.0,0.0014646420389820111,0.055201698513800426
96,108,294.0,3994,112,3882,159888.0,0.0007004903432402681,0.028042063094641963
97,109,3821.0,18974,3144,15830,156856.0,0.0200438618860611,0.16570043217033836
98,110,1549.0,8726,1166,7560,158834.0,0.007340997519422794,0.13362365344946137
99,111,851.0,30752,239,30513,159761.0,0.001495984627036636,0.0077718522372528616
100,112,1430.0,20566,1376,19190,158624.0,0.008674601573532378,0.06690654478265098
101,113,1160.0,7835,841,6994,159159.0,0.00528402415194868,0.10733886407147415
102,114,118.0,10639,105,10534,159895.0,0.0006566809468713843,0.009869348622990883
103,115,8428.0,16742,6708,10034,153292.0,0.04375962215901678,0.4006689762274519
104,116,1369.0,10016,1012,9004,158988.0,0.0063652602712154375,0.10103833865814696
105,117,2503.0,4204,1067,3137,158933.0,0.006713520791780184,0.2538058991436727
106,118,125.0,7563,0,7563,160000.0,0.0,0.0
107,119,423.0,23270,389,22881,159611.0,0.0024371753826490654,0.016716802750322304
108,120,1208.0,10433,1018,9415,158982.0,0.006403240618434791,0.09757500239624269
109,121,1370.0,2769,147,2622,159853.0,0.0009195948777939732,0.05308775731310943
110,122,1368.0,28652,1197,27455,158803.0,0.007537640976555859,0.04177718832891247
111,123,388.0,15183,350,14833,159650.0,0.002192295646727216,0.023052097740894423
112,124,702.0,20363,688,19675,159312.0,0.004318569850356533,0.03378677012228061
113,125,168.0,2710,95,2615,159905.0,0.000594102748506926,0.03505535055350553
114,126,43.0,7951,41,7910,159959.0,0.0002563156808932289,0.005156584077474532
115,127,226.0,1700,0,1700,160000.0,0.0,0.0
116,128,2534.0,6749,2227,4522,157773.0,0.014115216164996546,0.32997481108312343
117,129,162.0,10779,153,10626,159847.0,0.0009571652893079007,0.014194266629557473
118,130,1741.0,7781,423,7358,159577.0,0.0026507579413073312,0.05436319239172343
119,131,3984.0,9091,2847,6244,157153.0,0.018116103415143206,0.3131668683313167
120,132,1439.0,39270,1364,37906,158636.0,0.008598300511863638,0.03473389355742297
121,133,1226.0,1443,1,1442,159999.0,6.250039062744142e-06,0.000693000693000693
122,134,502.0,17306,389,16917,159611.0,0.0024371753826490654,0.02247775338033052
123,135,1479.0,823,184,639,159816.0,0.00115132402262602,0.2235722964763062
124,136,5231.0,13756,4188,9568,155812.0,0.02687854593997895,0.30444896772317537
125,137,251.0,15404,200,15204,159800.0,0.0012515644555694619,0.012983640612827837
126,138,841.0,23502,732,22770,159268.0,0.0045960268227139165,0.031146285422517232
127,139,9.0,5689,0,5689,160000.0,0.0,0.0
128,140,8878.0,26552,7592,18960,152408.0,0.04981365807569157,0.2859294968363965
129,141,3285.0,30900,2702,28198,157298.0,0.01717758649188165,0.08744336569579288
130,142,902.0,8583,673,7910,159327.0,0.004224017272653097,0.07841081207037166
131,143,1490.0,18449,1159,17290,158841.0,0.00729660478088151,0.06282183316168898
132,144,4774.0,10386,2424,7962,157576.0,0.015383053256841143,0.23339110340843444
133,145,28.0,372,0,372,160000.0,0.0,0.0
134,146,3963.0,7816,3528,4288,156472.0,0.02254716498798507,0.45138178096212894
135,147,27.0,7912,13,7899,159987.0,8.125660209892054e-05,0.0016430738119312437
136,148,696.0,4354,183,4171,159817.0,0.0011450596619883991,0.0420303169499311
137,151,423.0,9852,181,9671,159819.0,0.0011325311758927288,0.018371904181892003
138,152,17.0,18833,17,18816,159983.0,0.00010626129026209034,0.0009026708437317475
139,153,705.0,7070,503,6567,159497.0,0.0031536643322444937,0.07114568599717115
140,154,30.0,18196,30,18166,159970.0,0.00018753516284303307,0.0016487140030775995
141,156,176.0,15961,100,15861,159900.0,0.0006253908692933083,0.00626527159952384
142,158,120.0,460,1,459,159999.0,6.250039062744142e-06,0.002173913043478261
143,159,1578.0,4921,1124,3797,158876.0,0.007074699765855132,0.22840885998780736
144,160,1702.0,14240,1501,12739,158499.0,0.009470091293951382,0.10540730337078652
145,161,1000.0,3399,329,3070,159671.0,0.002060486876139061,0.09679317446307738
146,162,72.0,7446,0,7446,160000.0,0.0,0.0
147,163,1395.0,7700,1186,6514,158814.0,0.007467855478736131,0.15402597402597404
148,164,931.0,3850,46,3804,159954.0,0.0002875826800205059,0.011948051948051949
149,165,2129.0,3062,254,2808,159746.0,0.001590024163359333,0.0829523187459177
150,168,620.0,14070,498,13572,159502.0,0.003122217903223784,0.03539445628997868
151,169,390.0,2170,72,2098,159928.0,0.0004502025911660247,0.03317972350230415
152,170,433.0,22425,411,22014,159589.0,0.002575365470051194,0.018327759197324416
153,171,20.0,3669,0,3669,160000.0,0.0,0.0
154,172,109.0,2747,41,2706,159959.0,0.0002563156808932289,0.014925373134328358
155,173,199.0,11264,198,11066,159802.0,0.0012390333037133453,0.017578125
156,174,25085.0,23518,16569,6949,143431.0,0.11551896033632897,0.7045241942342035
157,175,22880.0,23974,14511,9463,145489.0,0.09973949920612554,0.6052807207808459
158,176,1756.0,6751,974,5777,159026.0,0.006124784626413291,0.14427492223374314
159,177,105.0,16502,0,16502,160000.0,0.0,0.0
160,178,424.0,17067,214,16853,159786.0,0.001339291302116581,0.012538817601218727
161,179,3780.0,7212,2619,4593,157381.0,0.016641144737928975,0.36314475873544094
162,180,3025.0,24119,2568,21551,157432.0,0.016311804461608823,0.10647207595671462
163,181,869.0,8856,797,8059,159203.0,0.005006187069339146,0.08999548328816621
164,182,8338.0,12350,6577,5773,153423.0,0.042868409560496146,0.5325506072874494
165,183,1339.0,10294,761,9533,159239.0,0.0047789800237379035,0.07392655916067613
166,184,1280.0,12711,832,11879,159168.0,0.005227181342983514,0.06545511761466447
167,185,4094.0,7398,2642,4756,157358.0,0.016789740591517433,0.3571235469045688
168,186,4475.0,7655,2903,4752,157097.0,0.01847902888024596,0.37922926192031353
169,187,6006.0,14905,4948,9957,155052.0,0.03191187472589841,0.33196913787319693
170,188,1511.0,6309,801,5508,159199.0,0.005031438639689948,0.12696148359486448
171,189,4591.0,13396,2751,10645,157249.0,0.017494546865162896,0.20535980889817856
172,190,22783.0,27737,18326,9411,141674.0,0.1293533040642602,0.6607059162851066
173,191,13746.0,19613,12042,7571,147958.0,0.08138796144851917,0.6139805231224188
174,192,3198.0,17504,1614,15890,158386.0,0.010190294596744661,0.0922074954296161
175,193,4072.0,14901,2706,12195,157294.0,0.017203453405724312,0.18159855043285686
176,194,7954.0,23449,5277,18172,154723.0,0.0341061122134395,0.22504157959827711
177,195,7374.0,24538,4883,19655,155117.0,0.031479463888548644,0.19899747330670797
178,196,4178.0,9481,3350,6131,156650.0,0.02138525375039898,0.353338255458285
179,197,14163.0,20813,10485,10328,149515.0,0.07012674313614019,0.503771681160813
180,198,8257.0,18939,6957,11982,153043.0,0.04545781251020955,0.36733724061460477
181,199,17344.0,26712,13544,13168,146456.0,0.09247828699404599,0.5070380353399221
182,200,130.0,2909,47,2862,159953.0,0.0002938363144173601,0.01615675489859058
183,201,545.0,7332,435,6897,159565.0,0.0027261617522639676,0.05932896890343699
184,202,656.0,6535,259,6276,159741.0,0.001621374600133967,0.0396327467482785
185,203,16276.0,20137,14068,6069,145932.0,0.0964010635090316,0.6986144907384417
186,204,13922.0,31152,11336,19816,148664.0,0.07625248883388043,0.36389316897791474
187,205,902.0,5332,703,4629,159297.0,0.0044131402349071236,0.13184546136534134
188,206,4785.0,19048,2607,16441,157393.0,0.016563633706708686,0.1368647627047459
189,208,75.0,3483,4,3479,159996.0,2.500062501562539e-05,0.0011484352569623888
190,209,702.0,7822,247,7575,159753.0,0.0015461368487602737,0.03157760163641012
191,210,1372.0,18874,742,18132,159258.0,0.00465910660688945,0.039313341104164456
192,211,825.0,10236,657,9579,159343.0,0.004123180811206014,0.0641852286049238
193,212,403.0,8621,345,8276,159655.0,0.002160909461025336,0.04001855933186405
194,213,1550.0,10849,1144,9705,158856.0,0.007201490658206174,0.10544750668264356
195,214,122.0,10760,46,10714,159954.0,0.0002875826800205059,0.004275092936802974
196,215,1144.0,6162,887,5275,159113.0,0.005574654490833559,0.143946770529049
197,216,914.0,10468,794,9674,159206.0,0.004987249224275467,0.07585021016431027
198,217,946.0,20229,490,19739,159510.0,0.00307190771738449,0.02422265065005685
199,218,2436.0,17600,2045,15555,157955.0,0.012946725333164509,0.11619318181818182
200,219,4787.0,15903,3817,12086,156183.0,0.024439279563076646,0.2400176067408665
201,220,898.0,37277,879,36398,159121.0,0.005524098013461454,0.023580223730450413
202,221,91.0,10201,0,10201,160000.0,0.0,0.0
203,222,303.0,1373,0,1373,160000.0,0.0,0.0
204,223,332.0,4016,79,3937,159921.0,0.0004939939094928121,0.019671314741035856
205,224,190.0,5422,152,5270,159848.0,0.0009509033581902807,0.028033935817041684
206,225,32.0,1803,32,1771,159968.0,0.00020004000800160032,0.01774819744869662
207,226,239.0,1023,41,982,159959.0,0.0002563156808932289,0.04007820136852395
208,227,6684.0,16078,5653,10425,154347.0,0.03662526644508802,0.351598457519592
209,228,815.0,4920,213,4707,159787.0,0.001333024588984085,0.043292682926829265
210,229,2918.0,18147,2604,15543,157396.0,0.01654425779562378,0.14349479252769054
211,230,1809.0,21338,1149,20189,158851.0,0.007233193369887505,0.053847595838410346
212,231,3941.0,26297,3462,22835,156538.0,0.022116035722955448,0.13164999809864242
213,232,888.0,1020,109,911,159891.0,0.0006817144179472266,0.10686274509803921
214,233,524.0,8082,97,7985,159903.0,0.0006066177620182235,0.012001979707993072
215,234,4816.0,23033,4054,18979,155946.0,0.025996178164236338,0.17600833586593148
216,235,4988.0,16664,3587,13077,156413.0,0.022932876423315197,0.2152544407105137
217,236,1.0,20245,1,20244,159999.0,6.250039062744142e-06,4.939491232403063e-05
218,237,639.0,2593,207,2386,159793.0,0.0012954259573322987,0.07983031237948322
219,238,576.0,6190,372,5818,159628.0,0.002330418222367003,0.06009693053311793
220,239,529.0,17996,486,17510,159514.0,0.0030467545168449163,0.027006001333629695
221,240,1056.0,27787,991,26796,159009.0,0.006232351627895276,0.03566415949904632
222,241,3703.0,12543,2522,10021,157478.0,0.016014935419550666,0.20106832496213028
223,242,1000.0,2225,235,1990,159765.0,0.0014709103996494851,0.10561797752808989
224,243,57.0,2707,39,2668,159961.0,0.00024380942854820863,0.014407092722571112
225,244,91.0,12351,0,12351,160000.0,0.0,0.0
226,245,93.0,5923,22,5901,159978.0,0.00013751890884996688,0.003714333952388992
227,247,1318.0,6102,1138,4964,158862.0,0.007163450038398107,0.18649623074401836
228,248,13.0,5359,13,5346,159987.0,8.125660209892054e-05,0.0024258257137525657
229,250,444.0,13449,296,13153,159704.0,0.0018534288433602164,0.022009071306416834
230,251,480.0,4450,395,4055,159605.0,0.0024748598101563234,0.08876404494382023
231,252,86.0,4867,40,4827,159960.0,0.00025006251562890725,0.008218615163344977
232,253,4010.0,37830,3879,33951,156121.0,0.024846112950852223,0.10253766851704996
233,254,1505.0,3976,502,3474,159498.0,0.0031473748887133383,0.12625754527162977
234,255,794.0,7028,288,6740,159712.0,0.0018032458425165298,0.040978941377347755
235,256,5624.0,20121,4654,15467,155346.0,0.02995893038765079,0.23130063118135283
236,257,687.0,14224,541,13683,159459.0,0.0033927216400454034,0.038034308211473564
237,258,328.0,3969,264,3705,159736.0,0.0016527269995492563,0.06651549508692366
238,259,213.0,9196,188,9008,159812.0,0.0011763822491427428,0.02044367116137451
239,260,249.0,2784,0,2784,160000.0,0.0,0.0
240,261,52.0,7028,8,7020,159992.0,5.000250012500625e-05,0.0011383039271485487
241,262,98.0,15926,62,15864,159938.0,0.0003876502144581025,0.0038930051488132614
242,264,120.0,15637,23,15614,159977.0,0.00014377066703338606,0.001470870371554646
243,265,48.0,10041,48,9993,159952.0,0.00030009002700810244,0.004780400358530027
244,0,527.0,14282,40,14242,159960.0,0.00025006251562890725,0.0028007281893292256
245,2,1494.0,2768,831,1937,159169.0,0.0052208658721233404,0.3002167630057804
246,3,1047.0,8104,644,7460,159356.0,0.004041266096036547,0.07946692991115499
247,4,165.0,13308,46,13262,159954.0,0.0002875826800205059,0.0034565674782085962
248,5,1480.0,5566,165,5401,159835.0,0.001032314574404855,0.029644268774703556
249,7,76.0,20176,7,20169,159993.0,4.37519141462439e-05,0.0003469468675654243
250,9,168.0,13411,0,13411,160000.0,0.0,0.0
251,11,174.0,14028,42,13986,159958.0,0.00026256892434263994,0.0029940119760479044
252,12,400.0,1967,125,1842,159875.0,0.0007818608287724785,0.06354855109303507
253,14,15.0,1249,0,1249,160000.0,0.0,0.0
254,15,881.0,11062,315,10747,159685.0,0.001972633622444187,0.028475863315856085
255,16,347.0,12882,266,12616,159734.0,0.0016652685088960396,0.02064896755162242
256,17,469.0,25611,374,25237,159626.0,0.0023429767080550786,0.014603100230369762
257,18,1284.0,8730,1009,7721,158991.0,0.006346271172582096,0.11557846506300115
258,19,239.0,21043,223,20820,159777.0,0.001395695250255043,0.010597348286841229
259,20,1303.0,5116,834,4282,159166.0,0.005239812522774965,0.16301798279906177
260,23,100.0,19680,31,19649,159969.0,0.00019378754633710282,0.0015752032520325204
261,24,7442.0,15982,6314,9668,153686.0,0.04108376820269901,0.39506945313477665
262,25,1447.0,6462,364,6098,159636.0,0.0022801874263950485,0.05632930981120396
263,26,1010.0,7728,814,6914,159186.0,0.005113515007601171,0.10533126293995859
264,27,548.0,19646,543,19103,159457.0,0.003405306759816126,0.027639214089382063
265,28,211.0,12486,24,12462,159976.0,0.00015002250337550632,0.0019221528111484864
266,29,4956.0,17704,3891,13813,156109.0,0.0249248922227418,0.2197808404880253
267,30,707.0,8196,628,7568,159372.0,0.00394046633034661,0.07662274280136652
268,31,2258.0,14309,1981,12328,158019.0,0.012536467133699112,0.1384443357327556
269,32,387.0,3384,169,3215,159831.0,0.0010573668437286884,0.04994089834515367
270,34,12855.0,22806,11359,11447,148641.0,0.07641902301518423,0.49807068315355607
271,35,434.0,8611,334,8277,159666.0,0.0020918667718863126,0.038787597259319476
272,36,605.0,10199,518,9681,159482.0,0.003248015450019438,0.05078929306794784
273,39,108.0,6839,64,6775,159936.0,0.00040016006402561027,0.009358093288492469
274,40,282.0,14106,244,13862,159756.0,0.0015273291769949172,0.017297603856514958
275,42,4289.0,18448,3445,15003,156555.0,0.022005046149915365,0.18674111014744146
276,43,1101.0,3089,298,2791,159702.0,0.001865975379143655,0.09647134995144059
277,44,3660.0,19502,2966,16536,157034.0,0.018887629430569177,0.1520869654394421
278,45,2483.0,4049,497,3552,159503.0,0.003115928854002746,0.1227463571252161
279,46,87.0,54995,87,54908,159913.0,0.0005440458249172988,0.0015819619965451405
280,47,69.0,7751,65,7686,159935.0,0.0004064151061368681,0.008386014707779641
281,48,1181.0,9385,416,8969,159584.0,0.0026067776218167233,0.04432605221097496
282,49,1023.0,6404,855,5549,159145.0,0.005372459078199126,0.1335103060587133
283,50,1218.0,12761,912,11849,159088.0,0.005732676254651513,0.07146775331086905
284,51,225.0,8058,170,7888,159830.0,0.0010636301069886754,0.02109704641350211
285,52,1235.0,34243,853,33390,159147.0,0.005359824564710613,0.024910200624945245
286,53,3217.0,20874,2317,18557,157683.0,0.01469403803834275,0.11099932930918846
287,54,3287.0,8404,903,7501,159097.0,0.005675782698605253,0.10744883388862446
288,56,399.0,11682,154,11528,159846.0,0.000963427298775071,0.013182674199623353
289,57,11823.0,13904,8862,5042,151138.0,0.05863515462689727,0.6373705408515535
290,58,747.0,15687,236,15451,159764.0,0.0014771788387872111,0.015044304200930707
291,59,515.0,18108,168,17940,159832.0,0.001051103658841784,0.00927766732935719
292,60,2133.0,14115,1664,12451,158336.0,0.010509296685529508,0.11788877081119377
293,61,7390.0,18227,6435,11792,153565.0,0.041904079705662095,0.3530476765238383
294,62,242.0,17893,94,17799,159906.0,0.0005878453591484997,0.005253451070250936
295,63,79.0,7705,0,7705,160000.0,0.0,0.0
296,64,1508.0,5801,1103,4698,158897.0,0.006941603680371561,0.19013963109808654
297,65,915.0,12924,859,12065,159141.0,0.005397729057879491,0.06646549056019808
298,66,1529.0,20281,968,19313,159032.0,0.006086825293022788,0.04772940190325921
299,67,1783.0,19203,1423,17780,158577.0,0.008973558586680287,0.07410300473884289
300,68,2359.0,20205,1892,18313,158108.0,0.011966503908720621,0.09364018807225934
301,69,400.0,16785,365,16420,159635.0,0.002286466000563786,0.021745606196008342
302,70,1525.0,7187,827,6360,159173.0,0.00519560478221809,0.11506887435647697
303,71,1539.0,9855,1233,8622,158767.0,0.007766097488772856,0.12511415525114156
304,72,1666.0,25559,1401,24158,158599.0,0.008833599203021457,0.05481435110919833
305,73,1311.0,17449,1084,16365,158916.0,0.006821213722973143,0.062123903948650354
306,74,7440.0,14456,5499,8957,154501.0,0.03559200264075961,0.38039568345323743
307,75,4474.0,18283,2976,15307,157024.0,0.01895251681271653,0.16277416178964066
308,76,1531.0,23272,1330,21942,158670.0,0.008382176845024264,0.05715022344448264
309,77,3997.0,5955,1287,4668,158713.0,0.008108976580368337,0.21612090680100757
310,78,7312.0,20673,6180,14493,153820.0,0.04017683006111039,0.29894064722101293
311,79,13070.0,34178,12022,22156,147978.0,0.08124180621443729,0.3517467376675054
312,80,23293.0,30663,19557,11106,140443.0,0.13925222332191708,0.6378045201056648
313,81,3567.0,29297,3213,26084,156787.0,0.02049277044652937,0.10966993207495648
314,82,3993.0,19830,3068,16762,156932.0,0.0195498687329544,0.1547150781643974
315,83,6772.0,32275,6432,25843,153568.0,0.041883725776203376,0.1992873741285825
316,84,15498.0,42315,13581,28734,146419.0,0.09275435565056447,0.3209500177242113
317,85,12987.0,18315,9005,9310,150995.0,0.05963773634888572,0.49167349167349167
318,86,31702.0,46806,27930,18876,132070.0,0.2114787612629666,0.5967183694398154
319,87,1327.0,9844,307,9537,159693.0,0.0019224386792157451,0.031186509548963837
320,88,1455.0,8576,200,8376,159800.0,0.0012515644555694619,0.02332089552238806
321,89,1558.0,4069,406,3663,159594.0,0.0025439552865395942,0.09977881543376751
322,90,4441.0,26538,3359,23179,156641.0,0.02144393868782758,0.1265732157660713
323,91,413.0,3173,138,3035,159862.0,0.0008632445484230149,0.043491963441537974
324,92,1437.0,5830,1001,4829,158999.0,0.006295637079478487,0.17169811320754716
325,93,604.0,4872,167,4705,159833.0,0.0010448405523264908,0.03427750410509031
326,94,14.0,8328,5,8323,159995.0,3.125097659301853e-05,0.0006003842459173872
327,95,808.0,4508,446,4062,159554.0,0.0027952918761046416,0.09893522626441881
328,96,3779.0,9829,2433,7396,157567.0,0.015441050473766715,0.24753281106928476
329,97,3297.0,13159,2935,10224,157065.0,0.01868653105402222,0.22304126453377915
330,98,13659.0,24537,11679,12858,148321.0,0.07874137849663905,0.47597505807555934
331,99,3868.0,16098,2842,13256,157158.0,0.01808371193321371,0.17654367002112065
332,100,11257.0,38608,10542,28066,149458.0,0.07053486598241647,0.2730522171570659
333,101,924.0,17092,883,16209,159117.0,0.005549375616684578,0.05166159606833606
334,102,208.0,9056,108,8948,159892.0,0.0006754559327546094,0.011925795053003533
335,103,322.0,11531,270,11261,159730.0,0.0016903524697927752,0.023415141791691962
336,104,658.0,10296,404,9892,159596.0,0.0025313917642046167,0.03923853923853924
337,105,94.0,39277,94,39183,159906.0,0.0005878453591484997,0.002393258140896708
338,106,248.0,14091,144,13947,159856.0,0.000900810729656691,0.010219288907813498
339,107,1001.0,11559,308,11251,159692.0,0.001928712772086266,0.026645903624881045
340,108,294.0,5105,108,4997,159892.0,0.0006754559327546094,0.021155729676787464
341,109,3821.0,13855,3027,10828,156973.0,0.01928357105999121,0.2184770840851678
342,110,1549.0,10354,1166,9188,158834.0,0.007340997519422794,0.11261348271199537
343,111,851.0,21774,166,21608,159834.0,0.001038577524181338,0.00762377147056122
344,112,1430.0,19349,1369,17980,158631.0,0.008630091217983875,0.07075301049149826
345,113,1160.0,4439,821,3618,159179.0,0.005157715527802034,0.18495156566794324
346,114,118.0,6089,50,6039,159950.0,0.00031259768677711783,0.008211528986697324
347,115,8428.0,15064,7237,7827,152763.0,0.04737403690684262,0.480416887944769
348,116,1369.0,5581,612,4969,159388.0,0.0038396868020177176,0.10965776742519262
349,117,2503.0,4551,1107,3444,158893.0,0.006966952603324249,0.24324324324324326
350,118,125.0,8046,0,8046,160000.0,0.0,0.0
351,119,423.0,33103,384,32719,159616.0,0.0024057738572574178,0.011600157085460533
352,120,1208.0,10611,1054,9557,158946.0,0.006631182917468826,0.09933088304589577
353,121,1370.0,4139,200,3939,159800.0,0.0012515644555694619,0.048320850446967864
354,122,1368.0,17531,1132,16399,158868.0,0.007125412291965657,0.06457133078546574
355,123,388.0,15128,284,14844,159716.0,0.0017781562273034637,0.01877313590692755
356,124,702.0,17471,689,16782,159311.0,0.004324873988613467,0.03943678095129071
357,125,168.0,2223,84,2139,159916.0,0.0005252757697791341,0.037786774628879895
358,126,43.0,17908,43,17865,159957.0,0.00026882224597860673,0.002401161492070583
359,127,226.0,2268,0,2268,160000.0,0.0,0.0
360,128,2534.0,8129,2226,5903,157774.0,0.014108788520288514,0.27383441997785707
361,129,162.0,4395,89,4306,159911.0,0.0005565595862698626,0.02025028441410694
362,130,1741.0,4132,284,3848,159716.0,0.0017781562273034637,0.06873184898354308
363,131,3984.0,10764,3018,7746,156982.0,0.019225134091806702,0.28037904124860646
364,132,1439.0,51302,1386,49916,158614.0,0.008738194610816196,0.02701649058516237
365,133,1226.0,2494,4,2490,159996.0,2.500062501562539e-05,0.0016038492381716118
366,134,502.0,35981,460,35521,159540.0,0.0028832894571894194,0.012784525166059865
367,135,1479.0,1439,220,1219,159780.0,0.0013768932281887595,0.15288394718554552
368,136,5231.0,19225,4570,14655,155430.0,0.029402303287653607,0.23771131339401821
369,137,251.0,17881,204,17677,159796.0,0.0012766277003179052,0.011408757899446339
370,138,841.0,12508,671,11837,159329.0,0.004211411607428654,0.05364566677326511
371,139,9.0,2836,0,2836,160000.0,0.0,0.0
372,140,8878.0,25457,7398,18059,152602.0,0.04847905007798063,0.2906076914011863
373,141,3285.0,28725,2437,26288,157563.0,0.01546682914135933,0.08483899042645779
374,142,902.0,26297,822,25475,159178.0,0.005164030205179108,0.031258318439365704
375,143,1490.0,29060,1358,27702,158642.0,0.008560154309703609,0.04673090158293187
376,144,4774.0,35965,3600,32365,156400.0,0.023017902813299233,0.10009731683581259
377,145,28.0,1759,0,1759,160000.0,0.0,0.0
378,146,3963.0,12574,3587,8987,156413.0,0.022932876423315197,0.28527119452839195
379,147,27.0,20190,23,20167,159977.0,0.00014377066703338606,0.0011391778107974245
380,148,696.0,13907,283,13624,159717.0,0.0017718840198601277,0.020349464298554686
381,151,423.0,10258,160,10098,159840.0,0.001001001001001001,0.015597582374731916
382,152,17.0,20784,17,20767,159983.0,0.00010626129026209034,0.0008179368745188607
383,153,705.0,11004,515,10489,159485.0,0.0032291438066275827,0.046801163213376955
384,154,30.0,12359,29,12330,159971.0,0.00018128285751792513,0.0023464681608544383
385,156,176.0,16546,113,16433,159887.0,0.0007067491415812417,0.006829445183125831
386,158,120.0,784,15,769,159985.0,9.375878988655187e-05,0.01913265306122449
387,159,1578.0,7512,1368,6144,158632.0,0.008623732916435523,0.18210862619808307
388,160,1702.0,7991,865,7126,159135.0,0.005435636409337983,0.10824677762482793
389,161,1000.0,3618,454,3164,159546.0,0.0028455743171248416,0.12548369264787176
390,162,72.0,9924,0,9924,160000.0,0.0,0.0
391,163,1395.0,11502,1204,10298,158796.0,0.007582054963601099,0.1046774474004521
392,164,931.0,3502,88,3414,159912.0,0.0005503026664665567,0.025128498001142203
393,165,2129.0,4386,281,4105,159719.0,0.0017593398405950451,0.06406748746010033
394,168,620.0,14906,498,14408,159502.0,0.003122217903223784,0.03340936535623239
395,169,390.0,4855,64,4791,159936.0,0.00040016006402561027,0.013182286302780639
396,170,433.0,7596,264,7332,159736.0,0.0016527269995492563,0.03475513428120063
397,171,20.0,5478,18,5460,159982.0,0.00011251265767398832,0.0032858707557502738
398,172,109.0,5688,52,5636,159948.0,0.0003251056593392853,0.009142053445850914
399,173,199.0,29377,199,29178,159801.0,0.0012452988404327882,0.006774006876127583
400,174,25085.0,24896,17602,7294,142398.0,0.12361128667537466,0.707021208226221
401,175,22880.0,24505,15395,9110,144605.0,0.10646243214273365,0.6282391348704346
402,176,1756.0,13158,1236,11922,158764.0,0.007785140208107631,0.09393524851801185
403,177,105.0,15916,0,15916,160000.0,0.0,0.0
404,178,424.0,22574,375,22199,159625.0,0.0023492560689115116,0.016612031540710552
405,179,3780.0,14722,2770,11952,157230.0,0.017617503021051962,0.18815378345333514
406,180,3025.0,34961,2783,32178,157217.0,0.017701648040606296,0.0796029861846057
407,181,869.0,9477,798,8679,159202.0,0.005012499842966797,0.08420386198163976
408,182,8338.0,12892,6533,6359,153467.0,0.0425694123166544,0.5067483710828421
409,183,1339.0,6000,543,5457,159457.0,0.003405306759816126,0.0905
410,184,1280.0,13531,845,12686,159155.0,0.005309289686155006,0.06244919074717316
411,185,4094.0,8451,2806,5645,157194.0,0.017850554092395384,0.3320317122234055
412,186,4475.0,7256,2818,4438,157182.0,0.01792826150577038,0.38836824696802646
413,187,6006.0,7264,3626,3638,156374.0,0.023187998004783404,0.49917400881057267
414,188,1511.0,6993,868,6125,159132.0,0.005454591157026871,0.12412412412412413
415,189,4591.0,14510,2841,11669,157159.0,0.018077233884155535,0.19579600275671952
416,190,22783.0,28088,18399,9689,141601.0,0.1299355230542157,0.6550484192537739
417,191,13746.0,24061,12284,11777,147716.0,0.08315957648460559,0.5105357217073272
418,192,3198.0,19642,1751,17891,158249.0,0.011064840852074894,0.08914570817635678
419,193,4072.0,14478,2521,11957,157479.0,0.016008483670838652,0.17412626053322283
420,194,7954.0,18549,4766,13783,155234.0,0.030702036924900474,0.2569410749905655
421,195,7374.0,18376,3693,14683,156307.0,0.02362658102324272,0.2009686547670875
422,196,4178.0,9626,3418,6208,156582.0,0.021828818127243233,0.35507999168917515
423,197,14163.0,26103,10651,15452,149349.0,0.07131617888301897,0.4080373903382753
424,198,8257.0,16544,6624,9920,153376.0,0.043187982474441895,0.40038684719535783
425,199,17344.0,26213,12832,13381,147168.0,0.08719286801478582,0.48952809674588943
426,200,130.0,4220,47,4173,159953.0,0.0002938363144173601,0.01113744075829384
427,201,545.0,3333,208,3125,159792.0,0.0013016921998598178,0.06240624062406241
428,202,656.0,12505,346,12159,159654.0,0.0021671865408946847,0.02766893242702919
429,203,16276.0,19281,13561,5720,146439.0,0.09260511202616789,0.7033348892692288
430,204,13922.0,38080,11451,26629,148549.0,0.07708567543369528,0.30070903361344536
431,205,902.0,2862,590,2272,159410.0,0.003701147983188006,0.20614954577218728
432,206,4785.0,38790,2679,36111,157321.0,0.017028877263683805,0.06906419180201083
433,208,75.0,6266,24,6242,159976.0,0.00015002250337550632,0.003830194701563996
434,209,702.0,4749,192,4557,159808.0,0.0012014417300760913,0.04042956411876184
435,210,1372.0,22528,605,21923,159395.0,0.0037956021205182095,0.02685546875
436,211,825.0,13383,716,12667,159284.0,0.0044951156425001885,0.05350070985578719
437,212,403.0,6382,343,6039,159657.0,0.0021483555371828358,0.05374490755249138
438,213,1550.0,10478,1346,9132,158654.0,0.008483870561095213,0.12845962970032448
439,214,122.0,5152,57,5095,159943.0,0.0003563769592917477,0.011063664596273292
440,215,1144.0,7295,877,6418,159123.0,0.0055114596884171365,0.12021932830705963
441,216,914.0,13298,797,12501,159203.0,0.005006187069339146,0.0599338246352835
442,217,946.0,14211,396,13815,159604.0,0.0024811408235382573,0.02786573780873971
443,218,2436.0,8679,1557,7122,158443.0,0.009826877804636367,0.179398548219841
444,219,4787.0,11941,3666,8275,156334.0,0.02344979339107296,0.3070094631940373
445,220,898.0,17234,856,16378,159144.0,0.005378776454029056,0.04966925844261344
446,221,91.0,8024,0,8024,160000.0,0.0,0.0
447,222,303.0,2917,0,2917,160000.0,0.0,0.0
448,223,332.0,5253,273,4980,159727.0,0.0017091662649395532,0.051970302684180465
449,224,190.0,2956,159,2797,159841.0,0.000994738521405647,0.05378890392422192
450,225,32.0,2361,32,2329,159968.0,0.00020004000800160032,0.013553578991952562
451,226,239.0,5065,113,4952,159887.0,0.0007067491415812417,0.022309970384995065
452,227,6684.0,17449,5558,11891,154442.0,0.03598761994794162,0.31852828242306147
453,228,815.0,6932,557,6375,159443.0,0.0034934114385705237,0.08035199076745528
454,229,2918.0,15084,2323,12761,157677.0,0.014732649657210627,0.15400424290639086
455,230,1809.0,27664,1239,26425,158761.0,0.007804183647117365,0.04478744939271255
456,231,3941.0,26637,3284,23353,156716.0,0.020955103499323616,0.12328715696212036
457,232,888.0,4254,346,3908,159654.0,0.0021671865408946847,0.08133521391631406
458,233,524.0,18062,376,17686,159624.0,0.0023555355084448454,0.02081718525080279
459,234,4816.0,19091,3847,15244,156153.0,0.02463609408720934,0.20150856424493216
460,235,4988.0,19999,3996,16003,156004.0,0.025614727827491603,0.19980999049952497
461,236,1.0,12864,1,12863,159999.0,6.250039062744142e-06,7.77363184079602e-05
462,237,639.0,12514,483,12031,159517.0,0.003027890444278666,0.038596771615790317
463,238,576.0,10365,374,9991,159626.0,0.0023429767080550786,0.03608297153883261
464,239,529.0,28217,504,27713,159496.0,0.0031599538546421228,0.017861572810716944
465,240,1056.0,8320,986,7334,159014.0,0.00620071188700366,0.11850961538461538
466,241,3703.0,6957,2157,4800,157843.0,0.013665477721533422,0.3100474342388961
467,242,1000.0,1444,216,1228,159784.0,0.0013518249637009963,0.14958448753462603
468,243,57.0,2326,27,2299,159973.0,0.00016877848136873097,0.011607910576096303
469,244,91.0,5207,0,5207,160000.0,0.0,0.0
470,245,93.0,4171,0,4171,160000.0,0.0,0.0
471,247,1318.0,9377,1156,8221,158844.0,0.007277580519251593,0.12328036685507092
472,248,13.0,3517,0,3517,160000.0,0.0,0.0
473,250,444.0,14185,373,13812,159627.0,0.002336697425874069,0.026295382446246036
474,251,480.0,12956,398,12558,159602.0,0.0024937030864274883,0.030719357826489657
475,252,86.0,7760,58,7702,159942.0,0.00036263145390203947,0.007474226804123712
476,253,4010.0,29658,3868,25790,156132.0,0.024773909256270335,0.13042012273248366
477,254,1505.0,4188,524,3664,159476.0,0.0032857608668388975,0.1251193887297039
478,255,794.0,8564,313,8251,159687.0,0.001960084415137112,0.036548341896310135
479,256,5624.0,20371,4711,15660,155289.0,0.030336984590022473,0.23126012468705512
480,257,687.0,9922,505,9417,159495.0,0.0031662434559077087,0.05089699657327152
481,258,328.0,5410,266,5144,159734.0,0.0016652685088960396,0.049168207024029575
482,259,213.0,12109,199,11910,159801.0,0.0012452988404327882,0.016434057312742587
483,260,249.0,4656,5,4651,159995.0,3.125097659301853e-05,0.0010738831615120276
484,261,52.0,6306,10,6296,159990.0,6.250390649415588e-05,0.001585791309863622
485,262,98.0,14621,87,14534,159913.0,0.0005440458249172988,0.005950345393611928
486,264,120.0,11248,39,11209,159961.0,0.00024380942854820863,0.0034672830725462306
487,265,48.0,12127,48,12079,159952.0,0.00030009002700810244,0.003958110002473819
488,0,527.0,17305,39,17266,159961.0,0.00024380942854820863,0.002253683906385438
489,2,1494.0,3182,866,2316,159134.0,0.005441954579159702,0.2721558768070396
490,3,1047.0,3345,389,2956,159611.0,0.0024371753826490654,0.11629297458893871
491,4,165.0,17523,104,17419,159896.0,0.0006504227748036223,0.005935056782514409
492,5,1480.0,1857,77,1780,159923.0,0.0004814817130744171,0.041464728056004305
493,7,76.0,13278,3,13275,159997.0,1.8750351569091922e-05,0.00022593764121102577
494,9,168.0,11470,0,11470,160000.0,0.0,0.0
495,11,174.0,19239,64,19175,159936.0,0.00040016006402561027,0.0033265762253755393
496,12,400.0,5359,214,5145,159786.0,0.001339291302116581,0.039932823287926855
497,14,15.0,721,0,721,160000.0,0.0,0.0
498,15,881.0,18322,569,17753,159431.0,0.0035689420501659025,0.03105556161991049
499,16,347.0,9303,245,9058,159755.0,0.0015335983224312227,0.02633559066967645
500,17,469.0,25025,435,24590,159565.0,0.0027261617522639676,0.017382617382617382
501,18,1284.0,6690,1020,5670,158980.0,0.006415901371241666,0.15246636771300448
502,19,239.0,11693,207,11486,159793.0,0.0012954259573322987,0.017702899170443855
503,20,1303.0,3871,804,3067,159196.0,0.005050378150204779,0.20769826918109016
504,23,100.0,11769,0,11769,160000.0,0.0,0.0
505,24,7442.0,12956,6181,6775,153819.0,0.04018359240405932,0.47707625810435317
506,25,1447.0,9908,524,9384,159476.0,0.0032857608668388975,0.05288655631812677
507,26,1010.0,5865,707,5158,159293.0,0.004438362012141149,0.1205456095481671
508,27,548.0,37353,546,36807,159454.0,0.00342418503141972,0.014617299815275882
509,28,211.0,12989,12,12977,159988.0,7.500562542190664e-05,0.0009238586496266071
510,29,4956.0,13411,3418,9993,156582.0,0.021828818127243233,0.254865408992618
511,30,707.0,6079,621,5458,159379.0,0.003896372796918038,0.10215495969731864
512,31,2258.0,15724,1986,13738,158014.0,0.012568506588023847,0.1263037395064869
513,32,387.0,6018,292,5726,159708.0,0.0018283367145039697,0.04852110335659687
514,34,12855.0,20704,11206,9498,148794.0,0.0753121765662594,0.5412480680061824
515,35,434.0,8528,362,8166,159638.0,0.002267630514038011,0.0424484052532833
516,36,605.0,12817,543,12274,159457.0,0.003405306759816126,0.0423656081766404
517,39,108.0,5753,60,5693,159940.0,0.0003751406777541578,0.010429341213280027
518,40,282.0,10442,202,10240,159798.0,0.0012640959211003893,0.01934495307412373
519,42,4289.0,10995,3359,7636,156641.0,0.02144393868782758,0.3055025011368804
520,43,1101.0,3195,283,2912,159717.0,0.0017718840198601277,0.08857589984350547
521,44,3660.0,13950,2803,11147,157197.0,0.01783112909279439,0.20093189964157707
522,45,2483.0,10646,1463,9183,158537.0,0.009228129711045372,0.13742250610557957
523,46,87.0,66995,87,66908,159913.0,0.0005440458249172988,0.001298604373460706
524,47,69.0,10824,69,10755,159931.0,0.0004314360567994948,0.006374722838137472
525,48,1181.0,18825,998,17827,159002.0,0.00627665060816845,0.05301460823373174
526,49,1023.0,3844,811,3033,159189.0,0.005094573117489273,0.21097814776274715
527,50,1218.0,18179,1084,17095,158916.0,0.006821213722973143,0.05962924253259255
528,51,225.0,14673,219,14454,159781.0,0.0013706260443982702,0.014925373134328358
529,52,1235.0,29998,690,29308,159310.0,0.004331178206013433,0.023001533435562372
530,53,3217.0,14623,1922,12701,158078.0,0.012158554637583977,0.13143677767899883
531,54,3287.0,10636,1450,9186,158550.0,0.00914538000630716,0.13632944716058668
532,56,399.0,4830,3,4827,159997.0,1.8750351569091922e-05,0.0006211180124223603
533,57,11823.0,15198,8903,6295,151097.0,0.058922414078373495,0.5858007632583234
534,58,747.0,8404,248,8156,159752.0,0.0015524062296559667,0.029509757258448358
535,59,515.0,15111,83,15028,159917.0,0.0005190192412313888,0.0054926874462312225
536,60,2133.0,5611,1260,4351,158740.0,0.00793750787451178,0.22455890215647833
537,61,7390.0,18968,6420,12548,153580.0,0.041802318010157574,0.3384647827920709
538,62,242.0,20725,97,20628,159903.0,0.0006066177620182235,0.004680337756332931
539,63,79.0,7064,0,7064,160000.0,0.0,0.0
540,64,1508.0,15317,1200,14117,158800.0,0.007556675062972292,0.07834432330090749
541,65,915.0,12287,866,11421,159134.0,0.005441954579159702,0.07048099617481891
542,66,1529.0,23071,1065,22006,158935.0,0.006700852549784503,0.04616184820770664
543,67,1783.0,13499,1427,12072,158573.0,0.008999009919721516,0.10571153418771762
544,68,2359.0,19928,1843,18085,158157.0,0.011652977737311658,0.09248293857888398
545,69,400.0,18877,360,18517,159640.0,0.0022550739163117012,0.01907082693224559
546,70,1525.0,7238,949,6289,159051.0,0.005966639631313227,0.13111356728378004
547,71,1539.0,15212,1312,13900,158688.0,0.008267795926598105,0.08624769918485406
548,72,1666.0,22683,1352,21331,158648.0,0.00852201099288992,0.0596041088039501
549,73,1311.0,20816,1195,19621,158805.0,0.007524951985139007,0.05740776325903151
550,74,7440.0,15203,5535,9668,154465.0,0.03583336030816042,0.36407288035256197
551,75,4474.0,22327,3350,18977,156650.0,0.02138525375039898,0.15004254937967484
552,76,1531.0,12335,1024,11311,158976.0,0.00644122383252818,0.08301580867450345
553,77,3997.0,5850,1318,4532,158682.0,0.008305920016132895,0.2252991452991453
554,78,7312.0,20219,6286,13933,153714.0,0.0408941280560001,0.3108956921707305
555,79,13070.0,35860,12122,23738,147878.0,0.08197297772488132,0.3380368098159509
556,80,23293.0,34888,19356,15532,140644.0,0.13762407212536618,0.5548039440495299
557,81,3567.0,23324,3125,20199,156875.0,0.0199203187250996,0.13398216429428914
558,82,3993.0,37804,3204,34600,156796.0,0.020434194749866068,0.0847529361972278
559,83,6772.0,36237,6437,29800,153563.0,0.04191764943378288,0.17763611778016944
560,84,15498.0,26331,13027,13304,146973.0,0.08863532757717404,0.49474004025673163
561,85,12987.0,31898,9652,22246,150348.0,0.06419772793785085,0.3025895040441407
562,86,31702.0,46767,28588,18179,131412.0,0.21754482086871824,0.6112857356683131
563,87,1327.0,9257,840,8417,159160.0,0.005277707966825836,0.09074214108242411
564,88,1455.0,8025,219,7806,159781.0,0.0013706260443982702,0.027289719626168225
565,89,1558.0,3977,364,3613,159636.0,0.0022801874263950485,0.09152627608750315
566,90,4441.0,23390,3411,19979,156589.0,0.02178313930097261,0.14583155194527575
567,91,413.0,11657,199,11458,159801.0,0.0012452988404327882,0.0170712876383289
568,92,1437.0,5336,999,4337,159001.0,0.006282979352331118,0.18721889055472263
569,93,604.0,2402,194,2208,159806.0,0.0012139719409784363,0.08076602830974189
570,94,14.0,6889,4,6885,159996.0,2.500062501562539e-05,0.0005806357961968355
571,95,808.0,4007,434,3573,159566.0,0.0027198776681749246,0.10831045670077365
572,96,3779.0,26808,3074,23734,156926.0,0.019588850795916546,0.11466726350343182
573,97,3297.0,19423,3064,16359,156936.0,0.019523882346943976,0.15775111980641507
574,98,13659.0,25348,11642,13706,148358.0,0.07847234392483048,0.45928672873599496
575,99,3868.0,9597,2666,6931,157334.0,0.01694484345405316,0.27779514431593205
576,100,11257.0,25283,9720,15563,150280.0,0.06467926537130689,0.38444804809555827
577,101,924.0,7231,422,6809,159578.0,0.0026444748022910426,0.05835983957958789
578,102,208.0,9976,142,9834,159858.0,0.0008882883559158753,0.014234161988773055
579,103,322.0,22001,290,21711,159710.0,0.001815791121407551,0.013181219035498386
580,104,658.0,17195,497,16698,159503.0,0.003115928854002746,0.028903751090433267
581,105,94.0,35391,87,35304,159913.0,0.0005440458249172988,0.002458252097991015
582,106,248.0,17168,79,17089,159921.0,0.0004939939094928121,0.004601584342963654
583,107,1001.0,7445,245,7200,159755.0,0.0015335983224312227,0.03290799194089993
584,108,294.0,12595,239,12356,159761.0,0.001495984627036636,0.018975784041286223
585,109,3821.0,26170,3345,22825,156655.0,0.021352653921036673,0.12781811234237678
586,110,1549.0,17419,1234,16185,158766.0,0.007772444981923082,0.07084218382226305
587,111,851.0,17383,104,17279,159896.0,0.0006504227748036223,0.005982856814128746
588,112,1430.0,16531,1368,15163,158632.0,0.008623732916435523,0.08275361442139012
589,113,1160.0,9571,886,8685,159114.0,0.005568334653141773,0.09257130916309686
590,114,118.0,10389,96,10293,159904.0,0.0006003602161296778,0.009240542881894312
591,115,8428.0,12853,6189,6664,153811.0,0.04023769431315055,0.48152182369874735
592,116,1369.0,7917,928,6989,159072.0,0.005833836250251459,0.11721611721611722
593,117,2503.0,13043,1200,11843,158800.0,0.007556675062972292,0.09200337345702676
594,118,125.0,8477,0,8477,160000.0,0.0,0.0
595,119,423.0,22106,378,21728,159622.0,0.0023680946235481327,0.017099430018999367
596,120,1208.0,19932,1168,18764,158832.0,0.007353681877707263,0.05859923740718443
597,121,1370.0,1872,119,1753,159881.0,0.0007443035757844897,0.06356837606837606
598,122,1368.0,47276,1226,46050,158774.0,0.0077216672754985075,0.025932820035536
599,123,388.0,19802,282,19520,159718.0,0.0017656118909578132,0.014240985759014241
600,124,702.0,30765,692,30073,159308.0,0.004343786878248424,0.022493092800260035
601,125,168.0,6661,141,6520,159859.0,0.0008820272865462689,0.021167992793874792
602,126,43.0,12849,43,12806,159957.0,0.00026882224597860673,0.0033465639349365708
603,127,226.0,1387,0,1387,160000.0,0.0,0.0
604,128,2534.0,10143,2264,7879,157736.0,0.014353096312826495,0.22320812382924185
605,129,162.0,6648,124,6524,159876.0,0.0007756010908454052,0.01865222623345367
606,130,1741.0,1629,180,1449,159820.0,0.0011262670504317356,0.11049723756906077
607,131,3984.0,15795,3271,12524,156729.0,0.020870419641546872,0.20709085153529597
608,132,1439.0,17505,1293,16212,158707.0,0.008147088660235528,0.07386461011139675
609,133,1226.0,1728,1,1727,159999.0,6.250039062744142e-06,0.0005787037037037037
610,134,502.0,34607,441,34166,159559.0,0.0027638679109294995,0.012743086658768457
611,135,1479.0,3951,238,3713,159762.0,0.001489715952479313,0.06023791445203746
612,136,5231.0,15841,4239,11602,155761.0,0.02721477134841199,0.2675967426298845
613,137,251.0,15211,195,15016,159805.0,0.0012202371640436783,0.012819669975675498
614,138,841.0,26194,751,25443,159249.0,0.00471588518609222,0.028670687943803924
615,139,9.0,4588,0,4588,160000.0,0.0,0.0
616,140,8878.0,22556,7023,15533,152977.0,0.045908862116527324,0.31135839687887923
617,141,3285.0,15141,1795,13346,158205.0,0.01134603836794033,0.11855227527904366
618,142,902.0,9475,724,8751,159276.0,0.00454556869836008,0.07641160949868074
619,143,1490.0,24096,1292,22804,158708.0,0.008140736446807975,0.05361885790172643
620,144,4774.0,20397,3655,16742,156345.0,0.023377786305925997,0.1791930185811639
621,145,28.0,183,0,183,160000.0,0.0,0.0
622,146,3963.0,13921,3641,10280,156359.0,0.023286155577868877,0.2615473026363049
623,147,27.0,2140,5,2135,159995.0,3.125097659301853e-05,0.002336448598130841
624,148,696.0,3845,218,3627,159782.0,0.0013643589390544618,0.056697009102730817
625,151,423.0,13897,351,13546,159649.0,0.0021985731197815207,0.025257249766136577
626,152,17.0,7664,17,7647,159983.0,0.00010626129026209034,0.0022181628392484343
627,153,705.0,6203,508,5695,159492.0,0.003185112732927043,0.08189585684346284
628,154,30.0,13359,30,13329,159970.0,0.00018753516284303307,0.0022456770716370988
629,156,176.0,15492,98,15394,159902.0,0.0006128753861740316,0.0063258455977278595
630,158,120.0,614,3,611,159997.0,1.8750351569091922e-05,0.004885993485342019
631,159,1578.0,5916,1280,4636,158720.0,0.008064516129032258,0.21636240703177823
632,160,1702.0,4358,798,3560,159202.0,0.005012499842966797,0.18311151904543368
633,161,1000.0,4119,458,3661,159542.0,0.0028707174286394803,0.11119203690216072
634,162,72.0,9733,0,9733,160000.0,0.0,0.0
635,163,1395.0,11688,1212,10476,158788.0,0.007632818600901831,0.10369609856262833
636,164,931.0,3947,40,3907,159960.0,0.00025006251562890725,0.010134279199391943
637,165,2129.0,4644,274,4370,159726.0,0.0017154376870390543,0.05900086132644272
638,168,620.0,8436,445,7991,159555.0,0.002789006925511579,0.052750118539592224
639,169,390.0,4842,135,4707,159865.0,0.0008444625152472399,0.027881040892193308
640,170,433.0,12227,330,11897,159670.0,0.0020667626980647585,0.026989449578801013
641,171,20.0,7451,16,7435,159984.0,0.00010001000100010001,0.0021473627700979736
642,172,109.0,8015,50,7965,159950.0,0.00031259768677711783,0.006238303181534623
643,173,199.0,5497,153,5344,159847.0,0.0009571652893079007,0.027833363652901583
644,174,25085.0,28157,19913,8244,140087.0,0.14214737984252643,0.7072131263984089
645,175,22880.0,25016,15834,9182,144166.0,0.10983172176518735,0.6329549088583307
646,176,1756.0,7522,969,6553,159031.0,0.006093151649678365,0.12882212177612337
647,177,105.0,14639,0,14639,160000.0,0.0,0.0
648,178,424.0,25314,348,24966,159652.0,0.002179740936536968,0.01374733349134866
649,179,3780.0,13290,2986,10304,157014.0,0.01901741246003541,0.22468021068472535
650,180,3025.0,14684,2172,12512,157828.0,0.013761816661175456,0.14791609915554346
651,181,869.0,6436,770,5666,159230.0,0.004835772153488664,0.11963952765692977
652,182,8338.0,13402,6609,6793,153391.0,0.0430859698417769,0.49313535293239813
653,183,1339.0,8075,671,7404,159329.0,0.004211411607428654,0.08309597523219814
654,184,1280.0,17740,884,16856,159116.0,0.00555569521606878,0.04983089064261556
655,185,4094.0,9483,2650,6833,157350.0,0.016841436288528758,0.27944743224717916
656,186,4475.0,6001,2624,3377,157376.0,0.01667344448962993,0.4372604565905682
657,187,6006.0,13722,4687,9035,155313.0,0.0301777700514445,0.3415682845066317
658,188,1511.0,7700,406,7294,159594.0,0.0025439552865395942,0.05272727272727273
659,189,4591.0,14389,2780,11609,157220.0,0.017682228724080904,0.19320314128848426
660,190,22783.0,30650,19119,11531,140881.0,0.13571028030749355,0.623784665579119
661,191,13746.0,19539,11545,7994,148455.0,0.07776767370583679,0.5908695429653513
662,192,3198.0,16659,1630,15029,158370.0,0.010292353349750583,0.09784500870400384
663,193,4072.0,15621,2774,12847,157226.0,0.01764339231424828,0.1775814608539786
664,194,7954.0,6600,3368,3232,156632.0,0.0215026303692732,0.5103030303030303
665,195,7374.0,18162,3662,14500,156338.0,0.023423607824073482,0.2016297764563374
666,196,4178.0,10425,3471,6954,156529.0,0.02217480466878342,0.3329496402877698
667,197,14163.0,21076,10344,10732,149656.0,0.06911851178703159,0.4907952173087872
668,198,8257.0,18239,7000,11239,153000.0,0.0457516339869281,0.383792971105872
669,199,17344.0,22873,12428,10445,147572.0,0.08421651803865232,0.5433480522887247
670,200,130.0,1630,45,1585,159955.0,0.00028132912381607326,0.027607361963190184
671,201,545.0,6182,443,5739,159557.0,0.0027764372606654676,0.07165965706890974
672,202,656.0,7597,325,7272,159675.0,0.002035384374510725,0.04278004475450836
673,203,16276.0,20980,14018,6962,145982.0,0.0960255373950213,0.6681601525262154
674,204,13922.0,40673,12213,28460,147787.0,0.08263920371886567,0.3002729083175571
675,205,902.0,3604,649,2955,159351.0,0.004072770174018362,0.18007769145394006
676,206,4785.0,13529,2757,10772,157243.0,0.017533371914807017,0.20378446300539582
677,208,75.0,3924,16,3908,159984.0,0.00010001000100010001,0.004077471967380225
678,209,702.0,9978,346,9632,159654.0,0.0021671865408946847,0.034676287833233115
679,210,1372.0,15372,573,14799,159427.0,0.003594121447433622,0.037275565964090554
680,211,825.0,9071,591,8480,159409.0,0.0037074443726514816,0.06515268437878954
681,212,403.0,4309,336,3973,159664.0,0.002104419280489027,0.07797632861452773
682,213,1550.0,12852,1343,11509,158657.0,0.008464801426977694,0.10449735449735449
683,214,122.0,14628,40,14588,159960.0,0.00025006251562890725,0.0027344818156959257
684,215,1144.0,11020,912,10108,159088.0,0.005732676254651513,0.08275862068965517
685,216,914.0,24437,846,23591,159154.0,0.005315606268142805,0.034619634161312765
686,217,946.0,21473,474,20999,159526.0,0.0029713024836076876,0.02207423275741629
687,218,2436.0,19974,2065,17909,157935.0,0.013074999208535157,0.10338439971963552
688,219,4787.0,8226,3168,5058,156832.0,0.020199959192001633,0.3851203501094092
689,220,898.0,18651,877,17774,159123.0,0.0055114596884171365,0.047021607420513645
690,221,91.0,10516,0,10516,160000.0,0.0,0.0
691,222,303.0,2219,0,2219,160000.0,0.0,0.0
692,223,332.0,6557,163,6394,159837.0,0.0010197889099520137,0.024858929388439834
693,224,190.0,10979,179,10800,159821.0,0.001120003003360009,0.016303852809909827
694,225,32.0,1489,29,1460,159971.0,0.00018128285751792513,0.019476158495634655
695,226,239.0,4130,85,4045,159915.0,0.0005315323765750555,0.020581113801452784
696,227,6684.0,15684,5516,10168,154484.0,0.03570596307708242,0.3516959959194083
697,228,815.0,4221,213,4008,159787.0,0.001333024588984085,0.05046197583511016
698,229,2918.0,12971,2527,10444,157473.0,0.016047195392225967,0.19481921208850514
699,230,1809.0,13048,853,12195,159147.0,0.005359824564710613,0.06537400367872472
700,231,3941.0,23605,3326,20279,156674.0,0.021228793545834023,0.14090235119678035
701,232,888.0,9057,330,8727,159670.0,0.0020667626980647585,0.0364359059291156
702,233,524.0,24082,356,23726,159644.0,0.0022299616647039663,0.014782825346731998
703,234,4816.0,25075,3909,21166,156091.0,0.025043083842117737,0.15589232303090728
704,235,4988.0,17040,3967,13073,156033.0,0.02542410900258279,0.23280516431924883
705,236,1.0,16105,1,16104,159999.0,6.250039062744142e-06,6.209251785159888e-05
706,237,639.0,1194,169,1025,159831.0,0.0010573668437286884,0.14154103852596314
707,238,576.0,12862,462,12400,159538.0,0.0028958618009502436,0.03591976364484528
708,239,529.0,12570,469,12101,159531.0,0.0029398674865700083,0.037311058074781224
709,240,1056.0,7189,994,6195,159006.0,0.006251336427556193,0.1382667964946446
710,241,3703.0,13766,2666,11100,157334.0,0.01694484345405316,0.19366555281127415
711,242,1000.0,1594,162,1432,159838.0,0.0010135261952727136,0.10163111668757842
712,243,57.0,3026,47,2979,159953.0,0.0002938363144173601,0.015532055518836747
713,244,91.0,5966,0,5966,160000.0,0.0,0.0
714,245,93.0,4149,0,4149,160000.0,0.0,0.0
715,247,1318.0,11769,1180,10589,158820.0,0.007429794736179322,0.10026340385759198
716,248,13.0,2804,0,2804,160000.0,0.0,0.0
717,250,444.0,13431,344,13087,159656.0,0.0021546324597885454,0.025612389248752886
718,251,480.0,7705,402,7303,159598.0,0.0025188285567488314,0.05217391304347826
719,252,86.0,10725,39,10686,159961.0,0.00024380942854820863,0.0036363636363636364
720,253,4010.0,14907,3359,11548,156641.0,0.02144393868782758,0.22533038169987255
721,254,1505.0,2467,260,2207,159740.0,0.0016276449229998748,0.1053911633563032
722,255,794.0,9135,282,8853,159718.0,0.0017656118909578132,0.030870279146141214
723,256,5624.0,20054,4758,15296,155242.0,0.030648922327720592,0.23725939962102324
724,257,687.0,10514,500,10014,159500.0,0.003134796238244514,0.04755564009891573
725,258,328.0,4041,262,3779,159738.0,0.0016401858042544668,0.06483543677307597
726,259,213.0,17530,200,17330,159800.0,0.0012515644555694619,0.011409013120365089
727,260,249.0,4809,0,4809,160000.0,0.0,0.0
728,261,52.0,7944,8,7936,159992.0,5.000250012500625e-05,0.0010070493454179255
729,262,98.0,21009,78,20931,159922.0,0.00048773777216392993,0.003712694559474511
730,264,120.0,23157,120,23037,159880.0,0.0007505629221916438,0.005182018396165306
731,265,48.0,10050,48,10002,159952.0,0.00030009002700810244,0.004776119402985075
732,0,527.0,16455,194,16261,159806.0,0.0012139719409784363,0.011789729565481617
733,2,1494.0,3030,867,2163,159133.0,0.005448272828388832,0.2861386138613861
734,3,1047.0,6585,550,6035,159450.0,0.003449357165255566,0.08352315869400152
735,4,165.0,18871,95,18776,159905.0,0.000594102748506926,0.0050341794287531135
736,5,1480.0,10613,232,10381,159768.0,0.0014521055530519252,0.02185998303966833
737,7,76.0,17115,8,17107,159992.0,5.000250012500625e-05,0.00046742623429739996
738,9,168.0,14141,0,14141,160000.0,0.0,0.0
739,11,174.0,16757,54,16703,159946.0,0.0003376139447063384,0.003222533866443874
740,12,400.0,2996,186,2810,159814.0,0.00116385297908819,0.062082777036048066
741,14,15.0,7805,0,7805,160000.0,0.0,0.0
742,15,881.0,19577,488,19089,159512.0,0.00305933095942625,0.024927210502119834
743,16,347.0,15136,282,14854,159718.0,0.0017656118909578132,0.01863107822410148
744,17,469.0,18017,377,17640,159623.0,0.0023618150266565595,0.020924682244546817
745,18,1284.0,6860,1030,5830,158970.0,0.006479209913820218,0.15014577259475217
746,19,239.0,4569,188,4381,159812.0,0.0011763822491427428,0.041146859268986646
747,20,1303.0,16799,982,15817,159018.0,0.006175401526871172,0.05845586046788499
748,23,100.0,35199,85,35114,159915.0,0.0005315323765750555,0.0024148413307196227
749,24,7442.0,34171,6365,27806,153635.0,0.041429361799069225,0.18626905855842674
750,25,1447.0,12473,611,11862,159389.0,0.0038333887533016707,0.0489858093481921
751,26,1010.0,5981,737,5244,159263.0,0.004627565724619026,0.12322354121384384
752,27,548.0,20699,543,20156,159457.0,0.003405306759816126,0.026233151359969082
753,28,211.0,11179,89,11090,159911.0,0.0005565595862698626,0.007961356114142589
754,29,4956.0,14520,3693,10827,156307.0,0.02362658102324272,0.2543388429752066
755,30,707.0,4807,617,4190,159383.0,0.0038711782310535,0.12835448304555855
756,31,2258.0,17170,2018,15152,157982.0,0.012773607119798459,0.11753057658707047
757,32,387.0,6466,306,6160,159694.0,0.0019161646649216626,0.04732446643983916
758,34,12855.0,18604,11426,7178,148574.0,0.0769044381924159,0.6141689959148571
759,35,434.0,2921,252,2669,159748.0,0.0015774845381475824,0.08627182471756248
760,36,605.0,11303,536,10767,159464.0,0.0033612602217428385,0.047421038662302045
761,39,108.0,5085,54,5031,159946.0,0.0003376139447063384,0.010619469026548672
762,40,282.0,9004,203,8801,159797.0,0.0012703617714975876,0.022545535317636606
763,42,4289.0,15954,3459,12495,156541.0,0.022096447576034392,0.21681083113952615
764,43,1101.0,3638,299,3339,159701.0,0.0018722487648793684,0.08218801539307312
765,44,3660.0,17786,2945,14841,157055.0,0.018751392824169877,0.16557966940290117
766,45,2483.0,12062,1422,10640,158578.0,0.008967195954041544,0.11789089703200133
767,46,87.0,49550,87,49463,159913.0,0.0005440458249172988,0.0017558022199798183
768,47,69.0,8291,69,8222,159931.0,0.0004314360567994948,0.008322277168013509
769,48,1181.0,9487,526,8961,159474.0,0.0032983433036106197,0.05544429218931169
770,49,1023.0,21772,908,20864,159092.0,0.005707389435043874,0.04170494212750322
771,50,1218.0,26121,1068,25053,158932.0,0.006719855032340875,0.040886642930975076
772,51,225.0,9186,197,8989,159803.0,0.0012327678454096607,0.0214456782059656
773,52,1235.0,17097,628,16469,159372.0,0.00394046633034661,0.03673159033748611
774,53,3217.0,14642,2505,12137,157495.0,0.015905266833867743,0.17108318535719164
775,54,3287.0,9732,1292,8440,158708.0,0.008140736446807975,0.1327579120427456
776,56,399.0,15047,255,14792,159745.0,0.0015962940937118532,0.01694689971422875
777,57,11823.0,14018,8704,5314,151296.0,0.05752961082910321,0.6209159651876159
778,58,747.0,13320,160,13160,159840.0,0.001001001001001001,0.012012012012012012
779,59,515.0,20983,124,20859,159876.0,0.0007756010908454052,0.00590954582280894
780,60,2133.0,10032,1471,8561,158529.0,0.009279059351916684,0.14663078149920256
781,61,7390.0,17544,6175,11369,153825.0,0.04014301966520396,0.35197218422252624
782,62,242.0,18380,94,18286,159906.0,0.0005878453591484997,0.005114254624591948
783,63,79.0,5995,0,5995,160000.0,0.0,0.0
784,64,1508.0,8307,1117,7190,158883.0,0.007030330494766589,0.13446490911279643
785,65,915.0,12572,830,11742,159170.0,0.005214550480618207,0.06601972637607381
786,66,1529.0,18313,1124,17189,158876.0,0.007074699765855132,0.061377163763446735
787,67,1783.0,25428,1445,23983,158555.0,0.009113556809939768,0.05682711971055529
788,68,2359.0,36260,1922,34338,158078.0,0.012158554637583977,0.053006067291781575
789,69,400.0,15634,354,15280,159646.0,0.0022174060107988925,0.02264295765638992
790,70,1525.0,7424,865,6559,159135.0,0.005435636409337983,0.11651400862068965
791,71,1539.0,17666,1329,16337,158671.0,0.008375821668735938,0.07522925393411072
792,72,1666.0,17458,1271,16187,158729.0,0.008007358453716713,0.07280329934700423
793,73,1311.0,22772,1181,21591,158819.0,0.007436137993565002,0.051861935710521695
794,74,7440.0,13465,5364,8101,154636.0,0.03468791225846504,0.39836613442257707
795,75,4474.0,24153,3243,20910,156757.0,0.02068807134609619,0.1342690349024966
796,76,1531.0,12911,1048,11863,158952.0,0.006593185364135085,0.0811710944156146
797,77,3997.0,3032,985,2047,159015.0,0.006194384177593309,0.324868073878628
798,78,7312.0,29590,6604,22986,153396.0,0.04305197006440846,0.22318350794187225
799,79,13070.0,41447,11994,29453,148006.0,0.08103725524640892,0.2893816199001134
800,80,23293.0,28522,19580,8942,140420.0,0.13943882637800883,0.6864876235888087
801,81,3567.0,21326,3062,18264,156938.0,0.01951088965069008,0.1435806058332552
802,82,3993.0,24440,3088,21352,156912.0,0.019679820536351585,0.12635024549918167
803,83,6772.0,23038,6309,16729,153691.0,0.041049898822962956,0.2738518968660474
804,84,15498.0,27099,13601,13498,146399.0,0.09290364005218615,0.5019004391305952
805,85,12987.0,28204,9782,18422,150218.0,0.06511869416448095,0.34683023684583747
806,86,31702.0,58950,29329,29621,130671.0,0.22444918918505255,0.49752332485156914
807,87,1327.0,17764,993,16771,159007.0,0.006245008081405221,0.055899572168430535
808,88,1455.0,6753,195,6558,159805.0,0.0012202371640436783,0.028876055086628164
809,89,1558.0,3975,420,3555,159580.0,0.0026319087604963027,0.10566037735849057
810,90,4441.0,17168,3146,14022,156854.0,0.0200568681704005,0.18324790307548927
811,91,413.0,19258,240,19018,159760.0,0.0015022533800701052,0.012462353307716273
812,92,1437.0,2586,908,1678,159092.0,0.005707389435043874,0.3511214230471771
813,93,604.0,5856,136,5720,159864.0,0.0008507231146474503,0.023224043715846996
814,94,14.0,6268,1,6267,159999.0,6.250039062744142e-06,0.0001595405232929164
815,95,808.0,7299,478,6821,159522.0,0.0029964519000514034,0.06548842307165365
816,96,3779.0,21887,2979,18908,157021.0,0.01897198463899733,0.13610819207748892
817,97,3297.0,26830,3073,23757,156927.0,0.01958235357841544,0.11453596720089453
818,98,13659.0,24189,11433,12756,148567.0,0.07695517847166598,0.4726528587374426
819,99,3868.0,8240,2784,5456,157216.0,0.01770812131080806,0.3378640776699029
820,100,11257.0,26902,10025,16877,149975.0,0.06684447407901317,0.3726488736896885
821,101,924.0,17010,883,16127,159117.0,0.005549375616684578,0.051910640799529686
822,102,208.0,14073,142,13931,159858.0,0.0008882883559158753,0.010090243729126697
823,103,322.0,26028,285,25743,159715.0,0.0017844285132892965,0.01094974642692485
824,104,658.0,15116,493,14623,159507.0,0.0030907734456795,0.032614448266737234
825,105,94.0,35437,87,35350,159913.0,0.0005440458249172988,0.002455061094336428
826,106,248.0,34632,174,34458,159826.0,0.0010886839437888704,0.005024255024255024
827,107,1001.0,10466,250,10216,159750.0,0.001564945226917058,0.02388687177527231
828,108,294.0,4472,104,4368,159896.0,0.0006504227748036223,0.023255813953488372
829,109,3821.0,45935,3286,42649,156714.0,0.020968133032147736,0.0715358658974638
830,110,1549.0,14472,1192,13280,158808.0,0.007505919097274697,0.08236594803758983
831,111,851.0,24559,95,24464,159905.0,0.000594102748506926,0.0038682356773484263
832,112,1430.0,24241,1388,22853,158612.0,0.008750914180515976,0.05725836392888082
833,113,1160.0,7396,880,6516,159120.0,0.005530417295123178,0.11898323418063818
834,114,118.0,5901,52,5849,159948.0,0.0003251056593392853,0.008812065751567531
835,115,8428.0,15373,7022,8351,152978.0,0.045902025127796155,0.45677486502309245
836,116,1369.0,13204,1189,12015,158811.0,0.007486886928487322,0.0900484701605574
837,117,2503.0,5340,1198,4142,158802.0,0.007543985592121006,0.2243445692883895
838,118,125.0,8432,0,8432,160000.0,0.0,0.0
839,119,423.0,21765,386,21379,159614.0,0.002418334231333091,0.017734895474385483
840,120,1208.0,14262,1177,13085,158823.0,0.007410765443292219,0.08252699481138691
841,121,1370.0,5451,166,5285,159834.0,0.001038577524181338,0.030453127866446522
842,122,1368.0,31807,1212,30595,158788.0,0.007632818600901831,0.0381048196937781
843,123,388.0,15503,309,15194,159691.0,0.0019349869435347014,0.019931626136876733
844,124,702.0,50801,693,50108,159307.0,0.00435009133308643,0.013641463750713569
845,125,168.0,1257,73,1184,159927.0,0.0004564582590807056,0.05807478122513922
846,126,43.0,14072,43,14029,159957.0,0.00026882224597860673,0.003055713473564525
847,127,226.0,2314,0,2314,160000.0,0.0,0.0
848,128,2534.0,12320,2274,10046,157726.0,0.014417407402711031,0.1845779220779221
849,129,162.0,7788,133,7655,159867.0,0.0008319415514146134,0.017077555213148434
850,130,1741.0,3810,262,3548,159738.0,0.0016401858042544668,0.06876640419947506
851,131,3984.0,27968,3344,24624,156656.0,0.021346134204882034,0.11956521739130435
852,132,1439.0,43702,1359,42343,158641.0,0.0085665118096835,0.03109697496682074
853,133,1226.0,1501,0,1501,160000.0,0.0,0.0
854,134,502.0,14028,411,13617,159589.0,0.002575365470051194,0.029298545765611635
855,135,1479.0,697,166,531,159834.0,0.001038577524181338,0.2381635581061693
856,136,5231.0,28091,4628,23463,155372.0,0.029786576731972297,0.1647502758890748
857,137,251.0,16551,198,16353,159802.0,0.0012390333037133453,0.011963023382272975
858,138,841.0,23725,705,23020,159295.0,0.00442575096519037,0.029715489989462593
859,139,9.0,3801,0,3801,160000.0,0.0,0.0
860,140,8878.0,13583,4460,9123,155540.0,0.028674296001028676,0.32835161599057644
861,141,3285.0,16537,2049,14488,157951.0,0.012972377509480788,0.12390397290923384
862,142,902.0,11398,759,10639,159241.0,0.004766360422253063,0.06659062993507633
863,143,1490.0,21147,1185,19962,158815.0,0.007461511821931178,0.056036317208114625
864,144,4774.0,10542,2927,7615,157073.0,0.018634647584244268,0.27765129956365014
865,145,28.0,789,0,789,160000.0,0.0,0.0
866,146,3963.0,24458,3687,20771,156313.0,0.02358728960483133,0.15074822144083735
867,147,27.0,15921,20,15901,159980.0,0.00012501562695336918,0.0012562024998429746
868,148,696.0,7693,257,7436,159743.0,0.0016088341899175552,0.03340699337059665
869,151,423.0,18659,331,18328,159669.0,0.0020730385986008557,0.017739428693927865
870,152,17.0,14832,17,14815,159983.0,0.00010626129026209034,0.001146170442286947
871,153,705.0,10353,521,9832,159479.0,0.0032668878034098534,0.050323577706944844
872,154,30.0,15968,30,15938,159970.0,0.00018753516284303307,0.00187875751503006
873,156,176.0,16936,121,16815,159879.0,0.000756822346899843,0.0071445441662730275
874,158,120.0,1274,50,1224,159950.0,0.00031259768677711783,0.03924646781789639
875,159,1578.0,5754,1235,4519,158765.0,0.00777879255503417,0.2146332985749044
876,160,1702.0,8300,882,7418,159118.0,0.005543056096733242,0.10626506024096385
877,161,1000.0,5221,489,4732,159511.0,0.0030656192989825153,0.0936602183489753
878,162,72.0,6537,0,6537,160000.0,0.0,0.0
879,163,1395.0,7185,1183,6002,158817.0,0.00744882474798038,0.16464857341684064
880,164,931.0,4193,73,4120,159927.0,0.0004564582590807056,0.017409968995945622
881,165,2129.0,2027,201,1826,159799.0,0.001257830149124838,0.09916132215096202
882,168,620.0,15270,512,14758,159488.0,0.0032102728731942215,0.0335297969875573
883,169,390.0,5406,83,5323,159917.0,0.0005190192412313888,0.015353311135775064
884,170,433.0,4570,186,4384,159814.0,0.00116385297908819,0.04070021881838074
885,171,20.0,5860,17,5843,159983.0,0.00010626129026209034,0.002901023890784983
886,172,109.0,1882,0,1882,160000.0,0.0,0.0
887,173,199.0,19205,199,19006,159801.0,0.0012452988404327882,0.010361884925800573
888,174,25085.0,20950,16270,4680,143730.0,0.1131983580324219,0.7766109785202864
889,175,22880.0,26546,16055,10491,143945.0,0.11153565597971447,0.6047992164544564
890,176,1756.0,6901,955,5946,159045.0,0.0060045898959414,0.13838574119692798
891,177,105.0,12431,0,12431,160000.0,0.0,0.0
892,178,424.0,10331,207,10124,159793.0,0.0012954259573322987,0.02003678249927403
893,179,3780.0,9765,2707,7058,157293.0,0.01720992033974811,0.2772145417306708
894,180,3025.0,14834,2683,12151,157317.0,0.017054736614606176,0.18086827558311985
895,181,869.0,7370,775,6595,159225.0,0.004867326110849427,0.10515603799185888
896,182,8338.0,13084,6599,6485,153401.0,0.0430179725034387,0.504356465912565
897,183,1339.0,9532,734,8798,159266.0,0.0046086421458440595,0.07700377675199328
898,184,1280.0,8936,684,8252,159316.0,0.004293354088729318,0.076544315129812
899,185,4094.0,8396,2516,5880,157484.0,0.015976226156307942,0.2996665078608861
900,186,4475.0,6708,2556,4152,157444.0,0.016234343639643302,0.3810375670840787
901,187,6006.0,9316,4180,5136,155820.0,0.026825824669490437,0.44869042507513957
902,188,1511.0,5748,718,5030,159282.0,0.004507728431335618,0.12491301322199026
903,189,4591.0,19853,3113,16740,156887.0,0.01984230688329817,0.1568024983629678
904,190,22783.0,30725,19218,11507,140782.0,0.13650892869827108,0.6254841334418226
905,191,13746.0,21927,12068,9859,147932.0,0.08157802233458616,0.5503716878733981
906,192,3198.0,17316,1666,15650,158334.0,0.010522060959743328,0.09621159621159621
907,193,4072.0,12541,2360,10181,157640.0,0.014970819588936818,0.18818276054541105
908,194,7954.0,12303,4342,7961,155658.0,0.027894486630947332,0.3529220515321466
909,195,7374.0,16714,3470,13244,156530.0,0.02216827445218169,0.20761038650233338
910,196,4178.0,12135,3532,8603,156468.0,0.02257330572385408,0.29105892047795634
911,197,14163.0,21256,10589,10667,149411.0,0.07087162257129663,0.4981652239367708
912,198,8257.0,25634,7068,18566,152932.0,0.04621661915099522,0.2757275493485215
913,199,17344.0,22404,13317,9087,146683.0,0.0907876168335799,0.5944027852169256
914,200,130.0,3412,47,3365,159953.0,0.0002938363144173601,0.013774912075029308
915,201,545.0,2275,109,2166,159891.0,0.0006817144179472266,0.04791208791208791
916,202,656.0,2912,206,2706,159794.0,0.0012891597932337886,0.07074175824175824
917,203,16276.0,20663,13936,6727,146064.0,0.09541023113155876,0.6744422397522141
918,204,13922.0,17559,11058,6501,148942.0,0.07424366531938607,0.6297625149495985
919,205,902.0,5859,694,5165,159306.0,0.004356395867073431,0.11845024748250554
920,206,4785.0,23324,3535,19789,156465.0,0.02259291215287764,0.15156062424969988
921,208,75.0,2366,0,2366,160000.0,0.0,0.0
922,209,702.0,7333,358,6975,159642.0,0.0022425176332042944,0.04882040092731488
923,210,1372.0,18449,676,17773,159324.0,0.004242926363887425,0.03664155238766329
924,211,825.0,8278,608,7670,159392.0,0.003814495081308974,0.07344769267939116
925,212,403.0,5021,340,4681,159660.0,0.002129525241137417,0.06771559450308703
926,213,1550.0,10392,1337,9055,158663.0,0.008426665322097779,0.12865665896843725
927,214,122.0,19921,102,19819,159898.0,0.0006379066654992558,0.00512022488830882
928,215,1144.0,6393,899,5494,159101.0,0.005650498739794218,0.1406225559205381
929,216,914.0,10002,792,9210,159208.0,0.004974624390734134,0.07918416316736653
930,217,946.0,16366,422,15944,159578.0,0.0026444748022910426,0.025785164365147255
931,218,2436.0,8836,1663,7173,158337.0,0.010502914669344499,0.188207333635129
932,219,4787.0,13818,3702,10116,156298.0,0.023685523807086464,0.26791141988710376
933,220,898.0,25074,868,24206,159132.0,0.005454591157026871,0.03461753210496929
934,221,91.0,10786,0,10786,160000.0,0.0,0.0
935,222,303.0,2455,0,2455,160000.0,0.0,0.0
936,223,332.0,4169,228,3941,159772.0,0.0014270335227699472,0.05468937395058767
937,224,190.0,6756,156,6600,159844.0,0.0009759515527639448,0.023090586145648313
938,225,32.0,1361,31,1330,159969.0,0.00019378754633710282,0.022777369581190303
939,226,239.0,1868,90,1778,159910.0,0.0005628165843286849,0.048179871520342615
940,227,6684.0,16733,5415,11318,154585.0,0.035029271921596536,0.3236120241439073
941,228,815.0,5155,390,4765,159610.0,0.0024434559238142974,0.07565470417070805
942,229,2918.0,9366,2250,7116,157750.0,0.014263074484944533,0.24023062139654067
943,230,1809.0,5079,480,4599,159520.0,0.003009027081243731,0.09450679267572357
944,231,3941.0,21204,3286,17918,156714.0,0.020968133032147736,0.15497076023391812
945,232,888.0,753,83,670,159917.0,0.0005190192412313888,0.1102257636122178
946,233,524.0,5813,111,5702,159889.0,0.0006942316231885871,0.01909513160158266
947,234,4816.0,14606,3356,11250,156644.0,0.021424376292740226,0.22976858825140353
948,235,4988.0,15576,3984,11592,156016.0,0.025535842477694595,0.25577812018489987
949,236,1.0,13577,0,13577,160000.0,0.0,0.0
950,237,639.0,8793,406,8387,159594.0,0.0025439552865395942,0.046173092232457635
951,238,576.0,13506,473,13033,159527.0,0.0029650153265591405,0.03502147193839775
952,239,529.0,17814,491,17323,159509.0,0.003078196214633657,0.02756259122038846
953,240,1056.0,38042,1005,37037,158995.0,0.006320953489103431,0.026418169391724936
954,241,3703.0,29787,3007,26780,156993.0,0.019153720229564377,0.10095007889347701
955,242,1000.0,1725,199,1526,159801.0,0.0012452988404327882,0.11536231884057971
956,243,57.0,2634,37,2597,159963.0,0.00023130348893181548,0.01404707668944571
957,244,91.0,3768,0,3768,160000.0,0.0,0.0
958,245,93.0,5592,5,5587,159995.0,3.125097659301853e-05,0.000894134477825465
959,247,1318.0,7125,1110,6015,158890.0,0.006985965133110957,0.15578947368421053
960,248,13.0,3490,0,3490,160000.0,0.0,0.0
961,250,444.0,7861,340,7521,159660.0,0.002129525241137417,0.043251494720773435
962,251,480.0,4461,391,4070,159609.0,0.002449736543678615,0.0876485093028469
963,252,86.0,20112,85,20027,159915.0,0.0005315323765750555,0.004226332537788385
964,253,4010.0,21747,3547,18200,156453.0,0.022671345388071817,0.16310295672966385
965,254,1505.0,4743,351,4392,159649.0,0.0021985731197815207,0.07400379506641366
966,255,794.0,10035,293,9742,159707.0,0.0018346096288828918,0.029197807673143995
967,256,5624.0,17745,4593,13152,155407.0,0.02955465326529693,0.2588334742180896
968,257,687.0,14957,540,14417,159460.0,0.0033864291985450895,0.036103496690512805
969,258,328.0,7037,266,6771,159734.0,0.0016652685088960396,0.03780019894841552
970,259,213.0,9840,192,9648,159808.0,0.0012014417300760913,0.01951219512195122
971,260,249.0,3329,0,3329,160000.0,0.0,0.0
972,261,52.0,6299,8,6291,159992.0,5.000250012500625e-05,0.0012700428639466582
973,262,98.0,17465,84,17381,159916.0,0.0005252757697791341,0.004809619238476954
974,264,120.0,21647,120,21527,159880.0,0.0007505629221916438,0.005543493324710122
975,265,48.0,3248,5,3243,159995.0,3.125097659301853e-05,0.001539408866995074
976,0,527.0,16260,33,16227,159967.0,0.0002062925478379916,0.002029520295202952
977,2,1494.0,2433,769,1664,159231.0,0.0048294615998141065,0.31607069461570075
978,3,1047.0,8806,671,8135,159329.0,0.004211411607428654,0.07619804678628209
979,4,165.0,12837,45,12792,159955.0,0.00028132912381607326,0.0035054919373685442
980,5,1480.0,6820,360,6460,159640.0,0.0022550739163117012,0.05278592375366569
981,7,76.0,27957,29,27928,159971.0,0.00018128285751792513,0.0010373072933433486
982,9,168.0,14441,0,14441,160000.0,0.0,0.0
983,11,174.0,18367,60,18307,159940.0,0.0003751406777541578,0.0032667283715359066
984,12,400.0,11786,206,11580,159794.0,0.0012891597932337886,0.01747836416086883
985,14,15.0,3598,0,3598,160000.0,0.0,0.0
986,15,881.0,12919,376,12543,159624.0,0.0023555355084448454,0.029104419846737364
987,16,347.0,13110,264,12846,159736.0,0.0016527269995492563,0.020137299771167048
988,17,469.0,24635,438,24197,159562.0,0.0027450144771311467,0.017779581895676883
989,18,1284.0,4869,931,3938,159069.0,0.00585280601499978,0.19120969398233723
990,19,239.0,16907,224,16683,159776.0,0.0014019627478469858,0.013248950138995682
991,20,1303.0,3357,775,2582,159225.0,0.004867326110849427,0.23086088769734883
992,23,100.0,18447,13,18434,159987.0,8.125660209892054e-05,0.0007047216349541931
993,24,7442.0,31201,6366,24835,153634.0,0.04143614043766354,0.20403192205378032
994,25,1447.0,9921,517,9404,159483.0,0.0032417248233354025,0.05211168229009173
995,26,1010.0,6832,794,6038,159206.0,0.004987249224275467,0.11621779859484778
996,27,548.0,14885,541,14344,159459.0,0.0033927216400454034,0.036345314074571713
997,28,211.0,29349,182,29167,159818.0,0.0011387953797444594,0.006201233432144196
998,29,4956.0,13289,3597,9692,156403.0,0.02299828008414161,0.2706749943562345
999,30,707.0,7060,620,6440,159380.0,0.0038900740368929604,0.08781869688385269
